Exposure to violent video games causes at least a temporary increase in aggression and this exposure correlates with aggression in the real world	neg
video game violence is not related to serious aggressive behavior in real life	pos
some violent video games may actually have a prosocial effect in some contexts	pos
exposure to violent video games causes both short term and long term aggression in players and decreases empathy and prosocial behavior	neg
Violent video games increase the violent tendencies among youth	neg
No conclusive link was found between video game usage and violent activity	pos
violent video games are significantly associated with: increased aggressive behavior, thoughts, and affect; increased physiological arousal; and decreased pro-social (helping) behavior	neg
video game publishers unethically train children in the use of weapons and, more importantly, harden them emotionally to the act of murder	neg
violent video games may increase mild forms of aggressive behavior in children and young adults	neg
exposure to violent video games results in increased physiological arousal, aggression-related thoughts and feelings as well as decreased prosocial behavior	neg
No long-term relationship was found between playing violent video game and youth violence or bullying	pos
No evidence has found that violent games are psychologically harmful to minors	pos
adolescents that don't play video games at all are most at-risk for violent behavior	neg
video game play is part of an adolescent boy's normal social setting	pos
Biological theories of aggression and violence have specifically excluded video game and other media effects	pos
Reinforcement of sexist stereotypes has been claimed as an effect of violent video games	neg
A correlation was found between children playing violent video games and suffering psychological effects	neg
violent video games can increase children's aggression	neg
Media influences are too weak and distant to have much influence on aggressiveness	pos
violent video games promote violent behavior, attitudes and beliefs by desensitizing an individual to aggression	neg
Excessive exposure to violent video games and other violent media has been linked to aggressive behaviour	neg
Neurological link was found between playing violent video games and aggressive behaviour in children and teenagers	neg
There is no direct link between violent video games and their influence on children	pos
Video games develop the individual's intelligence	pos
violent games help students deal with stress and aggression	pos
violent games affect students positively and not negatively	pos
many skills can be learned from the gaming experience, it builds practical and intellectual skills	pos
media cannot cause violence because humans have the ability to recognize what is wrong, and what is right	pos
video games have many healthy and positive aspects	pos
Video games can be a safe outlet for aggression and frustration	pos
Violent video games are influencing children's view about violence	neg
Various games are accused of causing addiction and even violent behavior	neg
exposure to graphic violence leads to desensitization to committing acts of violence in person	neg
violence in games hardens children to unethical acts	neg
children may imitate aggressive behaviors witnessed in media	neg
societal media consumption and violent crime rates are not well associated	pos
media violence may increase aggression	neg
Violent video games - especially first-person shooter games - encourages real-life acts of violence in teenagers	neg
video games allow children to act out crimes	neg
violence in video games is not causally linked with aggressive tendencies	pos
Correlations between violent gameplay and some comming childhood problems were found	neg
most children who play violent games do not have problems	pos
Many creative, social and emotional benefits from video game play have been documented - even games with violent content	pos
Not all depictions of violence are bad to witness	pos
There is no connection between exposure to media violence and real life violence	pos
heavy exposure to media violence can lead to more aggressive behavior	neg
Exposure alone to media violence does not cause a child to commit crimes	pos
there is no convincing evidence that prove that media violence cause violent crime or any type of real life violence	pos
Exposure to violent video games[REF] is related to increased aggressiveness in children	neg
numerous researchers have proposed potential positive effects of video games	pos
computer games cause violence	neg
A correlation between violent content conveyed through media (including videogames) and violent or aggressive behavior has been shown	neg
Some serious psychological problems have been attributed to desensitization to violence in video games	neg
Video games are protected speech under the First Amendment	pos
There is a connection between video games and violence	neg
content-based regulations are presumptively invalid	neg
No evidence links video games to youth violence	pos
There is no compelling link between violent video games and its effects on children	pos
content-based restrictions on games are unconstitutional	neg
states should have the “right to regulate the sale of video games [that are violent] in order to protect minors	pos
violent games cause youth violence	neg
A high degree of relationship between violent games and youth violence has been indicated	neg
video game violence leads to youth violence	neg
Video game content is a form of freedom of expression	pos
there is social utility in expressive and imaginative forms of entertainment, even if they contain violence	pos
There are tangible benefits to violence in games	pos
The policy is controversial both within and outside China because of the manner in which the policy has been implemented, and because of concerns about negative social consequences	neg
The policy is a possible cause behind China's gender imbalance	neg
The policy had proved remarkably effective	pos
The policy is considered as a great success in helping to implement China's current economic growth	pos
The reduction in the fertility rate and thus population growth has reduced the severity of problems that come with overpopulation	pos
the focus of China on population control helps provide a better health service for women	pos
The individual savings rate has increased since the one-child policy was introduced	pos
less intrusive options, including those that emphasized delay and spacing of births, could have achieved the same results over an extended period of time	pos
T]he policy itself is probably only partially responsible for the reduction in the total fertility rate	neg
China could have expected a continued reduction in its fertility rate just from continued economic development, had it kept to the previous policy	pos
The one-child policy is challenged in principle and in practice for violating a human right to determine the size of one's own family	neg
The policy leaves the older generations with increased chances of dependency on retirement funds or charity in order to receive support	neg
Some parents may over-indulge their only child	neg
The one child policy creates social problems and personality disorders in young people	neg
The one-child limit is too extreme. It violates nature’s law	neg
The social pressure exerted by the one-child policy has affected the rate at which parents abandon undesirable children	neg
China's family planning programs contribute to infanticide	neg
a single child would be left with having to provide support for his or her two parents and four grandparents	neg
Coercive sterilization to enforce the one child policy has occurred in China	neg
As a result of the one child policy, China successfully achieved its goal of a more stable and much-reduced fertility rate	pos
Rapid population growth is seen as an obstacle to development	neg
Population control is necessary for economic growth and improved living standards	pos
Coercive measures were used to achieve the desired results of the one-child policy	neg
Rapid fertility reduction associated with the one-child policy has potentially negative results	neg
a decrease in the human population would prevent a significant amount of man-made human suffering	pos
A continuation of the rapid population growth that had been occurring would hinder China's development as a nation	neg
the policy has created abuse for women in China	neg
implementation of the policy has involved forced abortions and forced sterilization	neg
China's gender imbalance is further increased by the One Child Policy	neg
China's birth control policy contributes to forced abortions	neg
China's birth control policy is thought to have been a significant contribution to the gender imbalance in mainland China	neg
the one-child policy is not effective enough to justify its costs	neg
the dramatic decrease in Chinese fertility started before the program began in 1979 for unrelated factors	neg
Population control involve measures that improve people's lives	pos
A large increase in population brings certain poverty on the citizenry	neg
Excessive population growth may reduce output per worker	neg
A larger population means more production	pos
overpopulation has been blamed for a variety of issues, including increasing poverty	neg
reduction of the population is a key to economic growth	pos
economists doubt that a correlation between population reduction and economic growth exists	neg
poverty and famine are caused by bad government and bad economic policies, not by overpopulation	pos
higher population density leads to more specialization and technological innovation, which in turn leads to a higher standard of living	pos
there is no correlation between population density and poverty and starvation	pos
There are a number of problems associated with overpopulation	neg
The success of the policy has been questioned, and reduction in fertility has also been attributed to the modernization of China	neg
The policy is controversial both within and outside of China	neg
Parents have a basic human right to determine freely and responsibly the number and the spacing of their children	pos
Parents have a basic right to decide freely and responsibly on the number and spacing of their children	pos
Parents have the exclusive right to determine freely and responsibly the number and spacing of their children	pos
governments have a responsibility to meet individuals' reproductive needs	pos
The human rights of women include their right to have control over and decide freely and responsibly on matters related to their sexuality	pos
Programs that do not take the interests of women into account are unlikely to succeed	neg
The policies' narrow focus leads to coercion and decreased quality of care	neg
this four-two-one reconfiguration of the familial structure has distinct ramifications for Chinese society	neg
only children are spoiled	neg
only children have aversive social skills	neg
Lack of siblings has been blamed for a number of social ills	neg
The one child policy has been speculated to be the underlying cause of forced abortions	neg
it is more difficult for only children to cooperate in a conventional family environment	neg
only children are higher in achievement motivation	pos
children with many siblings receive fewer resources	neg
Only children are more likely to make outside friends	pos
rapid population growth damages the Earth's resources and diminishes human well-being	neg
Overpopulation is seen as a serious threat to the quality of human life	neg
The use of drugs to enhance performance is considered unethical by most international sports organizations	neg
The use of performance-enhancing drugs is little different from the use of new materials in the construction of suits and sporting equipment, which similarly aid performance and can give competitors an unfair advantage over others	pos
The use of anabolic steroids is now banned by all major sporting bodies	neg
drug testing can be wildly inconsistent and, in some instances, has gone unenforced	neg
There is little danger from anabolica, when the athletes are kept on strictly monitored programmes	pos
The extremely dangerous side-effects of performance-enhancing drugs are admitted	neg
Often, doping was carried out without the knowledge of the athletes, some of them as young as ten years of age	neg
around 10,000 former athletes bear the physical and mental scars of years of drug abuse	neg
the pursuit of doping athletes has turned into a modern day witch-hunt	neg
Many sports organizations have banned the use of performance enhancing drugs and have very strict rules and consequences for people who are caught using them	neg
as outright prevention of doping is an impossibility, all doping should be legalised	pos
There are harmful long-term effects of many doping agents	neg
with doping legal, all competitive athletes would be compelled to use drugs, and the net effect would be a level playing field but with widespread health consequences	neg
doping could be legalized to some extent using a drug whitelist and medical counseling, such that medical safety is ensured, with all usage published	pos
Substance abuse can be harmful to your health and may even be deadly in certain scenarios	neg
"The use of performance-enhancing substances by players is illegal and ethically ""wrong"	neg
There is a wide range of health concerns for users of anabolic steroids	neg
Many former athletes suffer from health problems related to steroid consumption	neg
The extremely dangerous side-effects from anabolica are admitted	neg
former athletes bear the physical and mental scars of years of drug abuse	neg
Health risks can be produced by long-term use or excessive doses of anabolic steroids	neg
Frequent and regular physical exercise boosts the immune system	pos
Physical exercise helps prevent the diseases of affluence	pos
Physical exercise improves mental health	pos
physical exercise may help decrease some of the effects of childhood and adult obesity	pos
Physical exercise is important for maintaining physical fitness	pos
Physical exercise can contribute positively to maintaining a healthy weight	pos
Physical exercise can strenghten the immune system	pos
Frequent and regular aerobic exercise has been shown to help prevent or treat serious and life-threatening chronic conditions	pos
moderate exercise has a beneficial effect on the human immune system	pos
Exercise alone is a potential prevention method and/or treatment for mild forms of depression	pos
Too much exercise can be harmful	neg
Inappropriate exercise can do more harm than good	neg
Introducing students to activities like bowling, walking/hiking, or Frisbee at an early age can help students develop good activity habits that will carry over into adulthood	pos
Teaching non-traditional sports to students may provide the necessary motivation for students to increase their activity, and can help students learn about different cultures	pos
children who fail to engage in regular physical activity are at greater risk of obesity	neg
people can improve their health via exercise	pos
P.E. actually increases test scores	pos
youth do not get the physical outlet needed not only for their cognitive development but for their physical health	pos
Excess weight has reached epidemic proportions globally	neg
Physical fitness can prevent or treat many chronic health conditions	pos
To stay healthy it is important to engage in physical activity	pos
a lack of physical activity is thought to explain most cases of obesity	neg
A sedentary lifestyle plays a significant role in obesity [REF	neg
people die as a result of physical inactivity	neg
Inactivity is one of the leading preventable causes of death worldwide	neg
children learn best with freedom from coercion	pos
There are many health related benefits to being physically active	pos
Affirmative action counters the effects of a history of discrimination	pos
Affirmative action is intended to promote equal opportunity	pos
Affirmative action is intended to ensure that minority groups within a society are included in all programs	pos
Affirmative action helps to compensate for past discrimination, persecution or exploitation by the ruling class of a culture	pos
the principle of equality sometimes requires States parties to take affirmative action in order to diminish or eliminate conditions which cause or help to perpetuate discrimination prohibited by the Covenant	pos
In some countries which have laws on racial equality, affirmative action is rendered illegal because it does not treat all races equally	neg
Affirmative action laws cause disproportionally high costs for small companies and reduce economic growth and employment	neg
it is impossible to favor somebody without discriminating against others	neg
affirmative action devalues the accomplishments of people who are chosen based on the social group to which they belong rather than their qualifications	neg
affirmative action devalues the accomplishments of all those who belong to groups it is intended to help, therefore making affirmative action counterproductive	neg
"affirmative action is ""reverse discrimination"	neg
affirmative action has undesirable side-effects in addition to failing to achieve its goals	neg
Affirmative action may increase racial tension and benefit the more privileged people within minority groups at the expense of the least fortunate within majority groups	neg
affirmative action policies encourage non-preferred groups to designate themselves as members of preferred groups	neg
Affirmative action policies tend to benefit primarily the most fortunate among the preferred group	neg
Affirmative action policies increase animosity toward preferred groups	neg
affirmative action hurts its intended beneficiaries	neg
Merit should be a primary consideration during evaluation	pos
You can't legislate morality	neg
attempts at antidiscrimination have been criticized as reverse discrimination	neg
Affirmative action discriminates against members of a dominant or majority group	neg
each individual's civil rights include the right to be free from government sponsored social discrimination	neg
States must take measures to seek to eliminate prejudices	pos
Historical racism continues to be reflected in socio-economic inequality	neg
Policies adopted as affirmative action have been criticized as a form of referse discrimination	neg
Motivation for affirmative action policies is to redress the effects of past discrimination	pos
Affirmative action policies demonstrate an overt preference for applicants from particular backgrounds over better-qualified (or equally-qualified) candidates from other backgrounds	neg
the only consideration in choosing between applicants should be merit	pos
Affirmative action perpetuates racial division	neg
Differential treatment of racial groups is intended to ameliorate past discrimination	pos
recognition and rights accorded to specific groups may interfere with the state's need to establish a cohesive identity	neg
Affirmative action policies may be considered necessary because the minority group in question is socially disadvantaged	pos
affirmative action is racial division, not racial reconciliation	neg
Affirmative action policies redress imbalances and promote equality	pos
Affirmative action policies for specific racial groups guarantee the full and equal enjoyment of human rights and fundamental freedoms	pos
Discrimination is inherent in affirmative action programs	neg
identical treatment may sometimes act to preserve inequality rather than eliminate it	neg
jobs should go to those “most qualified	pos
The selection process should not be based on some arbitrary or irrelevant criterion	neg
race and sex shouldn't matter when getting a job	neg
final selection for posts must be made according to the principle the best person for the job	pos
The overall idea of affirmitive action is to give children from less fortunate backgrounds more of a chance	pos
The idea of affirmative action is to help disadvantaged groups get back to a normal starting position after a long period of discrimination	pos
any equalities achieved will entail future inequalities	neg
The impetus towards affirmative action is to redress the disadvantages[REF][REF][REF][REF][REF] associated with overt historical discrimination	pos
Policies adopted as affirmative action have been criticised as a form of reverse discrimination	neg
Affirmative action aims to correct the effects of past and present discrimination	pos
no one has a legal right to have any demographic characteristic they possess be considered a favorable point on their behalf	neg
Race-conscious affirmative action remains necessary to address race-based obstacles	pos
Affirmative action is often contested on constitutional grounds	neg
affirmative action requires the very discrimination it is seeking to eliminate	neg
Affirmative action is counter-productive	neg
affirmative action lowers the bar	neg
affirmative action has undesirable side-effects	neg
Affirmative action fails to achieve its goals	neg
Affirmative action hinders reconciliation	neg
Affirmative action replaces old wrongs with new wrongs	neg
Affirmative action undermines the achievements of minorities	neg
Affirmative action encourages groups to identify themselves as disadvantaged, even if they are not	neg
Affirmative action may increase racial tension	neg
affirmative action devalues the accomplishments of people who belong to a group it's supposed to help	neg
Affirmative action creates a cult of victimization	neg
Affirmative action policies reduce the incentives of both the preferred and non-preferred to perform at their best	neg
Affirmative action policies engender animosity toward preferred groups	neg
Affirmative action violates the principle of equal treatment just as much as negative discrimination	neg
one group is favored at the expense of another whenever a quota is invoked	neg
using quotas displaces individuals that would normally be favored based on their individual achievements	neg
qualifications should be the only determining factor	pos
Types of affirmative action that give preference to individuals solely based on their race or gender should not be permitted	neg
"social inequality today is due to ""cultural deficits"" of individual people or racial or ethnic groups"	neg
"there is no need to pay ""systematic attention"" to any current inequities"	neg
Affirmative action programs have at best a negligible impact on the groups they are intended to assist	neg
Preference policies reduce the incentives of both the preferred and non-preferred to perform at their best	neg
Direct intervention in the distribution of assets and opportunities is needed to resolve the economic disparities	pos
Affirmative action is designed to improve the well being of perceived backward and under represented communities	pos
The identification of oppressed classes is difficult to carry out	neg
Knocking a person unconscious or even causing concussion may cause permanent brain damage	neg
There is no clear division between the force required to knock a person out and the force likely to kill a person	neg
amateur boxers, professional boxers and Toughman fighters have died as the result of ring or training injuries	neg
Boxing is an obscenity that should not be sanctioned by any civilized society	neg
Medical Associations have called for bans on boxing	neg
boxing is the only sport where hurting the other athlete is the goal	neg
Boxing is the only sport where the intention is to inflict serious injury on your opponent	neg
Amateur boxers face a high risk of brain damage	neg
The typical knock out results in a sustained loss of consciousness	neg
Repeated blows to the head are known to gradually cause permanent brain damage	neg
In severe cases boxing may cause strokes or paralysis	neg
many physicians advise against sports involving knockouts	neg
fatalities are rare in heavyweight matches	pos
boxing remains the 8th most deadly sport	neg
Sports related to combat skills have been a part of human culture for thousands of years	pos
Contact sports have a higher risk of transmission of blood-borne disease between players	neg
full-contact sports are barbaric	neg
Full contact sports tend to cause injuries	neg
boxing may cause DP	neg
Boxing is very brutal	neg
a powerpunch can do a lot of damage to a boxer	neg
Diversity must be prevalent and valued	pos
differences are recognized as a uniting component rather than a separating one	pos
A multicultural society can never be strong	neg
many multicultural societies have failed	neg
Multiculturalism is a perilous concept on which to found policy	neg
Multiculturalism results in political corruption	neg
Multiculturalism creates friction within society	neg
"the diversity of cultural expressions is a ""rich asset for individuals and societies"	pos
promotion and maintenance of cultural diversity are an essential requirement for sustainable development	pos
diversity brings progress and social cohesion	pos
cultural diversity is as necessary for humankind as biodiversity is for the nature	pos
Cultural diversity is the common heritage of humanity	pos
cultural diversity may be vital for the long-term survival of humanity	pos
cultural diversity is as necessary for humankind as biodiversity is for nature	pos
It is unethical to conserve less developed societies	neg
it is in the best interests of individuals and of humanity as a whole that all people adhere to a specific model for society	pos
Multiculturalism can become a polite and euphemistic way of affirming and persisting unequal power relationships	neg
Multiculturalism tends to emphasize the rights of ethnic minorities at the expense of the majority	neg
The idea of multiculturalism had reached the end of its useful life	neg
cultural differences within society are valuable and should be preserved	pos
one does not need to assimilate or abandon one's heritage in order to blend in	neg
assimilation can hurt minority cultures by stripping away their distinctive features	neg
"separating citizens by ethnicity or race and providing immigrant groups ""special privileges"" can harm the very groups they are intended to help"	neg
the multiculturalist policy of freer immigration is unworkable in an era in which the supply of immigrants from third world countries seems limitless	neg
There is no rational ground for curtailing cultural freedoms	neg
multinationality in a single state should necessarily comprise the right to express and exercise national identity even by minorities	pos
Peoples have the right to the dignity and diversity of their cultures	pos
the distinctiveness of people's identity and their rights to preserve their heritage should be acknowledged	pos
Multicultural classrooms promote decision-making and critical thinking	pos
multiculturalism is a tool for instilling students with pride and confidence in their unique and special backgrounds	pos
Multicultural education provides a relatively fairer learning environment for international students	pos
multicultural education may cause abandonment of original cultural	neg
Diversity is intrinsically valuable to the dominant culture	pos
A homogeneous community grounded on consensus may be unable to criticize the injustice and exclusionary practices that undermine it	neg
Reform of cultural pathology often comes from the recognition of difference	pos
Multiculturalism is a developmental journey through which an individual enhances knowledge and skills about different cultures	pos
Multicultural education in public schools would promote acceptance of diversity	pos
Citizens in a diverse democratic society should be able to maintain attachments to their cultural communities	pos
Unity without diversity results in cultural repression	neg
the strongest nations are those that are made up of different racial elements	pos
multiculturalism helps in bringing together immigrants and minorities in the country	pos
official multiculturalism limits the freedom of minority members	neg
multiculturalism works better in theory than in practice	neg
Multiculturalism perpetuates conflicts between and within groups	neg
Multiculturalism hinders equity and equality in society	neg
diversity is valuable in itself, to preserve human historical heritage and knowledge	pos
Diversity makes available more ways of solving problems and responding to catastrophes	pos
The greater public good warrants eliminating those cultural characteristics that promote conflict or prevent harmony	neg
A community of separate cultures fosters a rights mentality, rather than a responsibilities mentality	neg
A community of separate cultures is divisive	neg
A community of separate cultures works against quick and effective integration	neg
multiculturalism obscures the social costs associated with large scale immigration	neg
Multiculturalism is divisive	neg
Multiculturalism threatens social cohesion	neg
Multiculturalism undermines national unity	neg
some forms of multiculturalism can divide people	neg
Multiculturalism is considered to be dangerous to the West	neg
all cultures and civilizations are of equal value	pos
All cultures and civilizations should be treated and promoted equally	pos
people have the right to maintain an affiliation with one's ethnic group	pos
the community is enriched as difference accrues	pos
multiculturalism has shifted from tolerating multiple cultures to tolerating multiple value systems, which can be hostile to liberalism	neg
Multiculturalism would lead to acceptance of barbaric practices	neg
homogeneity and integration are necessary for a society	pos
Multiculturalism and immigration lead to adaptation problems	neg
Lack of integration threatens society	neg
A liberal democracy cannot be multicultural	neg
Democracy and the rule of law can only be restored by abolishing multiculturalism	neg
The emphasis on group identity and group rights diminishes individual liberty for those within the minorities	neg
state multiculturalism has failed	neg
Unity is seen as an essential feature of the nation and the nation-state	pos
Multiculturalism allows people to truly express who they are within a society	pos
Multiculturalism promotes respect for the dignity of the lives and voices of the forgotten	pos
multiculturalism tries to restore a sense of wholeness in a postmodern era that fragments human life and thought	pos
Multiculturalism ultimately erodes the host nations' distinct culture	neg
the more racially diverse a community is, the greater the loss of trust	neg
recognition and rights accorded to specific groups may interfere with the state's need to establish a cohesive identity	neg
where members of minorities see that their specific needs and ambitions have been acknowledged and catered for, they will commit themselves more willingly to accepting the legitimacy of the nation	pos
the political function of rights is precisely to protect minorities from oppression by majorities	pos
cultural appreciation of ethnic and religious diversity promotes a greater willingness to tolerate political differences	pos
Gambling is a major international commercial activity	pos
Catholic and Jewish traditions have even set aside days for gambling	pos
religious authorities generally disapprove of gambling	neg
there is no moral impediment to gambling	pos
most legal jurisdictions limit gambling	neg
Many jurisdictions, local as well as national, either ban gambling or heavily control it by licensing	neg
regulation generally leads to gambling tourism and illegal gambling	neg
legal gambling provides significant government revenue	pos
Betting on team sports has become an important service industry in many countries	pos
many people participate in gambling as a form of recreation or even as a means to gain an income	pos
gambling, like any behavior which involves variation in brain chemistry, can become a psychologically addictive and harmful behavior	neg
gamblers persist in gambling even after repeated losses	neg
the social and economic consequences of casino gambling outweigh the initial revenue that may be generated	neg
gambling in some form or another has been seen in almost every society in history	pos
Most games played in the casino have mathematically-determined odds that ensure the house has at all times an advantage over the players	neg
Slot machine is addictive	neg
Given the large amounts of currency handled within a casino, both patrons and staff may be tempted to cheat and steal	neg
One area of controversy surrounding casinos is their relationship to crime rates	neg
There is a positive relationship between casinos and crime	neg
In charity gambling profits from the venture go to the charity or group of charities, rather than to a municipality or private casino	pos
problem gambling has been shown to cause dysfunctional families	neg
As a result of gambling, some are driven to extreme lengths to cover debt	neg
addicted gamblers spend most of their energy following their addiction	neg
Addicted gamblers cost companies loss of productivity and profit	neg
Gamblers may suffer from depression and bankruptcy	neg
The social costs of gambling to society are varied	neg
Gambling provides jobs	pos
gambling increases aggregate demand for goods and services in the economy	pos
Money from gambling goes directly towards stimulating the economy	pos
it is economically beneficial for a state to allow and support gambling institutions	pos
Pathological gambling is a common disorder that is associated with social costs	neg
Problem gambling leads to adverse consequences for the gambler, others, or for the community	neg
pathological gambling is an addiction similar to chemical addiction	neg
Problem gamblers have the erroneous belief that if they keep playing, they will eventually win	neg
Pathological gambling is similar to many other impulse control disorders	neg
As debts build up people turn to other sources of money such as theft	neg
Compulsive gambling is often very detrimental to personal relationships	neg
Abuse is common in homes where pathological gambling is present	neg
Problem gambling is often associated with increased suicidal ideation	neg
problem gambling increases the lifetime risk of suicide	neg
Internet gambling is a growing problem for banks and credit card companies	neg
Regulation of online gambling is a better alternative than the prohibition of internet gambling	pos
Internet gambling is a legitimate activity that citizens have the right to engage in	pos
Internet gambling has become one of the most popular and lucrative business present on the Internet	pos
Gambling is now a diverse, vibrant and innovative industry	pos
Gambling is a popular leisure activity enjoyed in many forms by millions of people	pos
Various forms of online gambling are legal and regulated in many countries	pos
the high-speed instant gratification of Internet games and the high level of privacy they offer may exacerbate problem and pathological gambling	neg
electronic funds transfers inherent in online gambling are being exploited by criminal interests	neg
The lotteries proved very popular and were hailed as a painless form of taxation	pos
There can be some problems associated with winning a lottery jackpot	neg
Winners sometimes feel anomie from the dramatic change of lifestyles	neg
lotteries facilitate a higher degree of inequality than a society should have	neg
any social system that allocates resources based on chance is one that is corrupt	neg
Any form of gambling is susceptible to fraud	neg
Gambling leads to increased political corruption, compulsive gambling and higher crime rates	neg
gambling is a type of regressive tax on the individuals	neg
nearly all the western states' governments outlawed gambling	neg
the majority of the states run some type of lottery to raise funds for state operations	pos
immigrants have high rates of criminality	neg
immigrants are thought to compete with employees who are already in the country	neg
immigration threatens national identity	neg
freedom of movement is often recognized as a civil right	pos
everyone has the right to leave or enter a country, along with movement within it	pos
everyone has the right to leave any country, including his own, and to return to his country	pos
the freedom of movement both within and between countries is a basic human right	pos
everyone has the right to seek and to enjoy in other countries asylum from persecution	pos
Political refugees may be fleeing for their lives	pos
prohibition of forcible return is part of customary international law	pos
In some of the illegal immigrants' countries of origin humanitarian hardship exists	neg
Illegal immigrants may serve as informants or as operatives of hostile states or terrorist organizations	neg
Immigrants are contributing to the congestion in the cities and to the rise in crime	neg
failing to stop the illegal immigration waves at an early stage will only lead to much larger waves of illegal immigration in the future	neg
refugees (legally defined to be people who are persecuted in their original country and then enter another country seeking safety) should be exempted from immigration laws	pos
repression and intolerance against immigrants will not solve the problems caused by the economic crisis	neg
countries must be prepared to allow Open borders for people fleeing conflict	pos
refugees have much to bring to the countries in which they are resettled in terms of culture and labor	pos
Frequently, countries of asylum are some of the world?s poorest nations and cannot handle the large influx of persons	neg
Refugee populations consist of people who are terrified and are away from familiar surroundings	pos
Asylum seekers are motivated by the availability of benefits	neg
Migration provides a positive resource for the economy	pos
the opposition to high levels of immigration by refugees is based on racism	neg
Immigrants are considered hostile or alien to the natural culture	neg
the immigrants will distort or spoil existing cultural values	neg
Immigrants acquire jobs which would have otherwise been available to native citizens, suppressing wages	neg
Immigrants damage a sense of community and nationality	neg
Immigrants may overpopulate countries	neg
Immigrants can swamp a native population and replace its culture with their own	neg
"immigrants can ""swamp"" a local population"	neg
everyone can exercise the right to seek asylum and find safe refuge in another state	pos
The system of monarchy since antiquity has contrasted with forms of democracy	neg
The monarch serves as a ceremonial figurehead symbol of national unity and state continuity	pos
a morally-based, balanced monarchy is stressed as the ideal form of government	pos
The hereditary nature of the monarchy is said to conflict with egalitarianism and dislike of inherited privilege	neg
The laws of succession are held by some to be sexist	neg
A monarch serves the traditional role of embodying and representing the nation	pos
Monarchy is a source of checks and balances against elected politicians who might seek powers in excess of those conferred by their respective constitutions	pos
Monarchy is a check against possible illegal action by politicians	pos
the monarch cannot be prosecuted for criminal offences	neg
Social traditions or hierarchies are essential for social order	pos
Monarchs rule with the intent of improving the lives of their subjects	pos
The sovereign knows the interests of his subjects better than they themselves	pos
The monarchy works well	pos
the monarchy is an outdated and regressive institution	neg
Royals are simply celebrities who should not have any formal role	neg
Constitutional monarchy is outdated	neg
republicanism is the next logical step toward a fully democratic constitution	pos
monarchy is unfair and elitist	neg
in a modern and democratic society no one should be expected to defer to another simply because of his birth	neg
Monarchy encourages attitudes which are more suited to a bygone age of imperialism	neg
maintaining a privileged royal family diminishes a society	neg
Monarchy encourages a feeling of dependency in many people who should instead have confidence in themselves and their fellow citizens	neg
Monarchy contradicts democracy	neg
it should be a fundamental right of the people of any nation to elect their head of state and for every citizen to be eligible to hold that office	pos
Monarchical prerogative powers can be used to circumvent normal democratic process with no accountability	neg
Monarchy is ethnic-discrimination	neg
Monarchy is gender-discriminative	neg
A monarchy demands deference	neg
Monarchy is the enemy of merit and aspiration	neg
Monarchy devalues intellect and achievement	neg
Monarchy harms the monarchs themselves	neg
a hereditary system condemns each heir to the throne to an abnormal childhood	neg
Monarchs lack accountability	neg
monarchs are not impartial	neg
monarchs are not accountable	neg
monarchy is expensive	neg
Monarchy is archaic	neg
Monarchy provides a safeguard against government instability	pos
Monarchy safeguards the constitutional rights of the individual	pos
Monarchy provides an impartial arbiter	pos
A monarch can act as an effective intermediary between vaious levels of government and political parties	pos
the Crown is a guarantor against the misuse of constitutional power by politicians	pos
Monarchy provides a focal point for unity and tradition	pos
A constitutional monarch with limited powers and non-partisan nature can provide a focus for national unity	pos
Monarchy provides continuity and stability	pos
Having a long serving monarch increases the sense of duty and continued stability of a nation	pos
monarchy is an impetus for significantly greater national income from tourism	pos
the monarchy is inherently contrary to egalitarianism and multiculturalism	neg
national pride is diminished by the monarchy	neg
monarchies are unfashionable	neg
people are given greater dignity from choosing their head of state	pos
Hereditary succession is outdated	neg
Monarchy is viewed as outdated and irrelevant	neg
The monarchy remains a symbol of imperialism and colonialism	neg
The principal advantage of hereditary monarchy is the immediate continuity of leadership	pos
Monarchy strengthens popular liberty	pos
The monarch is immune from criminal prosecution	neg
"a republic is ""inevitable"	pos
A single election in which the party nominee is selected by nonparty members could be enough to destroy the party	neg
The open primary can be seen as good for voter participation	pos
the open primary allows nonpartisan or independent voters to participate in the nominating process	pos
If nonpartisan or independent voters are allowed to help select the nominees then they may be more likely to vote in the general election	pos
With the open primary more voters become independent and are less likely to participate in the nominating or election processes	neg
the open primary leaves the party nominations vulnerable to manipulation and dilution	neg
Open primary may dilute the vote of a particular party and lead to a nominee who does not represent the views of his particular party	neg
the open primary is unconstitutional	neg
An open primary law is in general unconstitutional	neg
The male condom provides excellent protection against sexually transmitted infections	pos
Barrier contraceptives may increase the risk of pregnancy complications	neg
The use of condoms is encouraged to prevent transmission of HIV	pos
Condoms are widely recommended for the prevention of sexually transmitted diseases	pos
the Catholic Church should actively support condoms used to prevent disease	pos
condom-promotion programs encourage promiscuity	neg
Condoms may interfere with the process of paternal tolerance	neg
Condoms have the  feature of helping to prevent the spread of sexually transmitted diseases	pos
Condoms (male or female) are used to protect against STIs	pos
The best way to prevent being infected or infecting someone with an STI is by using protection during sexual intercourse	pos
Proper use of condoms reduces contact and risk	pos
The majority of HIV infections are acquired through unprotected sexual relations between partners	neg
Catholicism considers all forms of birth control to be sins	neg
Contraception is immoral	neg
Condoms can save life	pos
condoms protect against sexually transmitted diseases	pos
Condoms  prevent sexually transmitted infections	pos
"contraception ""contradicts the will of the Author of life [God"	neg
since artificial contraception expressly prevents the creation of a new life (and, the Church would argue, removes the sovereignty of God over all of Creation), contraception is unacceptable	neg
using condoms during sex is morally contraceptive and thus a sin	neg
Condoms impede the procreative aspect of the sexual act which is understood by the Church to have a deeply theological meaning	neg
permitting condom use as a method of preventing disease could be interpreted as permitting fornication	neg
promotion of condom use will lead to irresponsible, risky sexual behavior	neg
Condoms are a sin in any circumstances	neg
condoms are acceptable as a means of preventing AIDS	pos
condoms should be used to prevent the spread of HIV	pos
Condom use could encourage the spread of HIV by promoting extramarital sex	neg
condom use will prevent the spread of AIDS	pos
"the Church's ban on condoms has ""caused the death of millions"	neg
an act which deliberately attempts to divorce the unitive and procreative meaning of the marital act is opposed to God's plan for life	neg
the Catholic Church should support condoms used to prevent serious diseases such as AIDS, because non-use is tantamount to murder	pos
Birth control could open wide the way for marital infidelity	neg
a man who grows accustomed to the use of contraceptive methods may forget the reverence due to a woman	neg
Contraception is always seriously evil	neg
Contraception is gravely opposed to marital chastity	neg
Contraception is contrary to the good of the transmission of life	neg
Contraception denies the sovereign role of God in the transmission of human life	neg
the Catholic Church should support condoms used to prevent serious diseases such as AIDS	pos
birth control, in all forms, is sin	neg
Persons use condoms to protect against the spread of infections	pos
The problem of AIDS cannot be overcome by the distribution of prophylactics: on the contrary, they increase it	neg
Raising the school leaving age will tackle the problem of young people leaving school unskilled	pos
the history of the drive for compulsory schooling is not guided by altruism, but by a desire to coerce the population into a mold desired by the Establishment	neg
youths should have the right to control and direct their own learning	pos
the current compulsory schooling system violates a basic fundamental right of humans: the right to decide what enters our minds	neg
freedom of learning is part of freedom of thought	pos
forced schooling, regardless of whether the student is learning anything whatsoever, or if the student could more effectively learn elsewhere in different ways, is a gross violation of civil liberties	neg
Schools inhibit a person’s will and ability to self-learn	pos
forced schooling perverts the victims’ natural inclination to grow and learn	neg
high rates of education are essential for countries to be able to achieve high levels of economic growth	pos
release of tactical information usually presents a greater risk of casualties among one's own forces	neg
the right to freedom of speech is not absolute	neg
there must be no constraints on the free flow of information and ideas	pos
democracy will not be true to its essential ideal if those in power are able to manipulate the electorate by withholding information	neg
Access to information is increasingly recognised as a prerequisite for transparency and accountability of governments	pos
access to information is a basic human right	pos
The right of governments to forbid the publication of properly categorized state secrets is recognised	pos
the more freely information flows, the stronger societies become	pos
The individual freedom of expression is essential to the well-being of society	pos
The purpose of classification is to protect information from being used to damage or endanger national security	pos
Everyone has the right to freedom of opinion and expression	pos
Information should be free	pos
leaks .. may have a very negative security impact for people involved	neg
The decision to leak classified information is something that is illegal	neg
free speech is what regulates government and regulates law	pos
The purpose of censorship is to prevent the publication of security information which could benefit the enemy or harm the State	pos
Precisely because the repercussions that decisions of a security nature have on the life of nation, it is suitable to open the door to openly exchanging of views on security issues	pos
Authority to exercise censorship over the press .. is absolutely necessary to the public safety	pos
valuable farmland go to waste for the use of a recreational drug instead of being used to plant food crops	neg
Smoking is considered an immoral habit	neg
Subsidies may distort markets, and can impose large economic costs	neg
subsidies may distort the market and produce inefficiencies	neg
Tobacco use is described as the single most important preventable risk to human health in developed countries	neg
The cultivation of tobacco can be economically detrimental to developing countries	neg
When resources are put into tobacco production they are taken away from food production	neg
Government subsides for tobacco farming do not make economic sense	neg
The cultivation of tobacco is economically detrimental to the countries that produce it	neg
When resources are put into tobacco production, they are taken away from food production	neg
The market system is not adequately rewarding farm people for their agricultural commodities	neg
smoking tobacco is among the leading causes of many diseases	neg
Tobacco-related diseases are some of the biggest killers in the world today	neg
Toxic compounds in tobacco constitute serious health hazards	neg
Subsidies provide little benefit to the farmers themselves	neg
Tobacco is the single greatest cause of preventable death globally	neg
Tobacco use is described as the single most important preventable risk to human health	neg
Tobacco is being considered a usurper of good farm land	neg
Cigarette smoking produces substantial health-related economic costs to society	neg
Tobacco plays an important role in the economy of the producing areas	pos
tobacco causes cancer	neg
commercial tobacco production is a vital part of the American and world economy	pos
smoking-related health problems contribute to rising health care costs	neg
subsidised agriculture in the developed world is one of the greatest obstacles to economic growth in the developing world	neg
artificially low prices resulting from subsidies create unhealthy incentives for consumers	neg
Subsidies are an inefficient use of taxpayer’s money	neg
The free communication of thoughts and of opinions is one of the most precious rights of man	pos
a limitation on freedom of speech prescribed in law can be permitted if it can be justified as being a reasonable limit	pos
Freedom of expression is subject to certain restrictions	neg
Censorship is occasionally carried out to aid authorities or to protect an individual	pos
Freedom of speech may be restricted by law to protect rights and respectability of others	neg
human rights can be limited or even pushed aside during times of national emergency	neg
Government-enforced right of access inescapably dampens the vigor and limits the variety of public debate	neg
Everyone has the right to freedom of opinion and expression	pos
an effort to limit the use of words of language is actually a form of restricting freedom of thought	neg
limitations on free speech balance rights to free speech and other rights	pos
the individual must have unlimited access to the ideas of his fellow men in “a free and open encounter	pos
The individual freedom of expression is essential to the well-being of society	pos
"freedom can be restricted for reasons of ""sovereignty and integrity"	neg
The people should not be deprived or abridged of their right to speak, to write, or to publish their sentiments	pos
when a nation is at war, many things that might be said in time of peace are such a hindrance to its effort that their utterance will not be endured so long as men fight	neg
The right to free speech conflicts with other rights	neg
the freely expressed word can be a direct threat to other human rights	neg
The free communication of ideas and opinions is one of the most precious of the rights of man	pos
The right to freedom of speech and expression may be limited when conflicting with other rights	neg
the expression of dissent or subversive views should be tolerated	pos
"free discussion is necessary to prevent the ""deep slumber of a decided opinion"	pos
Speech can be justifiably suppressed in order to prevent harm from a clear and direct threat	neg
there must be no constraints on the free flow of information and ideas	pos
democracy will not be true to its essential ideal if those in power are able to manipulate the electorate by withholding information and stifling criticism	neg
freedom of speech helps to provide a balance between stability and change	pos
there ought to exist the fullest liberty of professing and discussing, as a matter of ethical conviction, any doctrine, however immoral it may be considered	pos
some forms of expression can be legitimately prohibited by law because they are very offensive	neg
Freedom of speech is a fundamental human right	pos
it is necessary to prevent the use of information resources and technologies for criminal and terrorist purposes	neg
the more freely information flows, the stronger societies become	pos
No human right is more basic than freedom of expression	pos
Clear and present danger is posed by discriminatory speech and the growth of e-hate	neg
Freedom of expression is the lifeblood of any free and open society	pos
liberty of expression 'is not absolute	neg
government may not prohibit the expression of an idea simply because society finds the idea offensive or disagreeable	neg
Punishment of dangerous or offensive writings is necessary for the preservation of peace and good order	pos
Reasonable restrictions upon free speech serve public order	pos
Freedom of speech and of the press lay at the foundation of all democratic organisations	pos
The freedom of speech and of the press does not confer an absolute right to express without any responsibility	neg
All the utterances intended to endanger the security of the State may be restrained in the interest of the security of the State	neg
Freedom of speech and expression can not be an excuse for distribution of indecent and immoral content	neg
Reasonable restrictions on freedom of expression can be imposed in the interest of public order	pos
censorship violates multiple Basic Human Rights	neg
one can not tolerate free speech concerning drugs	neg
Freedom of speech is the heart of democracy	pos
the right to freedom of speech can be subjected to limitations such as hate speech	neg
Without restrictions, total freedom of speech would allow freedom to slander	neg
Press freedom is the right of the people	pos
The American Jobs Act, would give businesses incentives to hire unemployed and disabled veterans	pos
The American Jobs Act gives more tax breaks, thus contributing more to the federal deficit	neg
to improve the economy, policymakers should focus on reforms that remove impediments to work	pos
vouchers and other forms of publicly funded private school choice are necessary to give families an opportunity to enroll their children in more effective private schools	pos
a voucher system for public education would make public schools compete with one another thus making them more accountable and efficient	pos
by distributing vouchers to the families of students equal to the tuition that he/she would receive at his/her local public school, a student’s family could then choose from options where best to send their child	pos
public education would be destroyed by tuition vouchers	neg
the tuition voucher proposal would undermine public education	neg
competition among schools will increase both the quality and the economic efficiency of public education	pos
Vouchers function to increase racial and economic discrimination in schools	neg
since approximately four out of five US private schools are religious, voucher and charter systems violate the Constitution	neg
"a ""competitive education market"" would lead to ""innovation and improvement"	pos
allowing families the option of both public and private schools undermines the public education system	neg
competition would improve schools and cost efficiency	pos
School voucher and education tax credit systems incentivize schools to increase accountability and school performance	pos
the competition spurred by vouchers and education tax credits increases the quality of both eligible private schools and local public schools	pos
Both private and public schools are improving through the use of vouchers	pos
vouchers improve academic outcomes at public schools	pos
Vouchers reduce racial segregation	pos
Vouchers deliver better services to special education students	pos
School vouchers would erode educational standards and reduce funding	neg
a voucher system would weaken public schools	neg
granting government money, even indirectly, to private and religious schools will inevitably lead to increased governmental control over non-government education	neg
Competition for students (and the education dollars that come with them) creates a catalyst for schools to create innovative programs	pos
School choice programs would allow poor students to opt out of bad schools and acquire a better education	pos
vouchers could result in nothing more than a cash-handout for many middle-class and wealthy families already sending their kids to private schools	neg
Through free competition between vendors for the provision of products and services, prices tend to decrease, and quality tends to increase	pos
with federal school vouchers inevitably come further central government regulation and loss of local control over education	neg
Education vouchers would undermine public schools	neg
Earmarks are Good for American Democracy	pos
Reducing earmarks does not reduce government spending	neg
In an already flawed system, earmarks can at least allow residents of Congressional districts to have a greater role in allocating federal funds	pos
directing money to particular purposes is a core constitutional function of Congress	pos
Congressmen tend to distribute specialized benefits at a great cost and ignore the particular costs the legislation bears upon the taxpayers	neg
Committee members can exploit pork barrel projects for electoral purposes	neg
power of the purse is one of Congress's primary checks on the executive branch	pos
the deployment, and implicit menace of use, of strong weapons is essential to threaten the enemy in order to prevent the use by said-enemy of the same weapons	pos
a nuclear nation might be hijacked by a despot or other person or persons who might use nuclear weapons without sane regard for the consequences	neg
Having more nuclear nuclear-weapon states will reduce security for all	neg
nuclear forces continue to play an essential role in war prevention	pos
reliance on nuclear weapons for deterrence is becoming increasingly hazardous and decreasingly effective	neg
nuclear weapon technology would soon reach the point where it could end human life on Earth	neg
nuclear weapons had become a source of extreme risk	neg
nuclear weapons can induce stability	pos
Nuclear weapons decrease the chances of crisis escalation	pos
controlled nuclear proliferation may be beneficial for inducing stability	pos
Nuclear proliferation increases the chance of inter-state nuclear conflict	neg
Nuclear proliferation increases the chances of nuclear material falling into the hands of non-state groups	neg
new nuclear states will use their acquired nuclear capabilities to deter threats and preserve peace	pos
new nuclear states often lack adequate organizational controls over their new weapons	neg
Nuclear weapons may lessen a state's reliance on allies for security, thus preventing allies from dragging each other into wars	pos
nuclear weapons induce stability in all regimes	pos
nuclear weapons contribute to stability at a strategic level	pos
public opinion is overwhelmingly opposed to nuclearization	neg
"the present situation whereby Nuclear Weapon States monopolise the right to possess nuclear weapons is ""highly discriminatory"	neg
more countries with nuclear weapons may increase the possibility of nuclear warfare	neg
The spread of nuclear weapons can increase international stability	pos
Nuclear proliferation will decrease the likelihood of war	pos
The effective prohibition on nuclear proliferation has been characterised as a form of technological apartheid	neg
the significance of nuclear weapons is purely to deter war	pos
The use of (or threat of use of) nuclear weapons would generally be contrary to the rules of international law applicable in armed conflict	neg
unlike conventional weapons, nuclear weapons successfully deter all-out war between states	pos
Nuclear disarmament would undermine deterrence	neg
Nuclear disarmament could lead to increased global instability	neg
an inferior nuclear force, by virtue of its extreme destructive power, could deter a more powerful adversary	pos
Nuclear weapons have become a source of extreme risk	neg
nuclear weapons are intended to deter other states from attacking	pos
Nuclear weapons give nations the potential to not only destroy their enemies but humanity itself	neg
Extreme danger is intrinsic to nuclear war and the possession of nuclear weapons	neg
with nuclear weapons more widely available, deterrence is decreasingly effective and increasingly hazardous	neg
if we hope to escape self-destruction, then nuclear weapons should have no place in our collective conscience, and no role in our security	neg
a full-scale nuclear war could potentially bring about the extinction of the human race	neg
the greater the threat of mutual destruction, the safer the world would be	pos
when two countries each have nuclear weapons, the probability of a direct war between them greatly decreases	pos
"collective bargaining is ""in the public interest"	pos
Collective bargaining contributes to the effective conduct of public business	pos
Collective bargaining facilitates and encourages the amicable settlements of disputes between employees and their employers	pos
Unionization frequently produces higher wages at the expense of fewer jobs	neg
unions promote deadweight loss	neg
The effect of union activities to influence pricing is potentially very harmful	neg
unionized workers raise their own wages above their natural rate at the expense of their businesses or other workers	neg
unions never raise productivity to compensate for higher wages	neg
unionized workers will spend their higher wages, driving economic growth and creating new jobs	pos
Unions may serve the practical purpose of leveling the playing-field between workers and powerful oligopolies	pos
there is an inherent right to collective bargaining	pos
unionisation produces higher wages (for the union members) at the expense of fewer jobs	neg
an individual cannot stand alone against the power of the company	neg
The right to collectively bargain is recognized through international human rights conventions	pos
The freedom of association and the effective recognition of the right to collective bargaining are defined as an essential right of workers	pos
Collective bargaining is regarded as a human right	pos
The right to bargain collectively with an employer enhances the human dignity	pos
Collective bargaining is intrinsically valuable as an experience in self-government	pos
Collective bargaining permits workers to achieve a form of workplace democracy	pos
abortion has negative effects on society	neg
the state has an interest in preserving fetal life	pos
Intact dilation and extraction  is never needed to protect the health of a pregnant woman	neg
partial-birth abortion .. is .. unnecessary to preserve the health of the mother	neg
A partial-birth abortion bears no relevance to any measure needed to advance the health of any woman	neg
abortion causes mental health problems	neg
the right of personal privacy includes the abortion decision	pos
there is a fundamental right to privacy encompassing the decision about abortion	pos
abortions should be legal under any circumstances	pos
Unborn children have an inherent right to life	pos
abortion, and especially late-term abortion, is unjust	neg
Critics consider the IDX procedure to be infanticide	neg
abortion should be legal in all circumstances	pos
The government should not interfere with a woman’s ability to have an abortion	pos
The human fetus is a person and therefore has a right to life	pos
legal abortion under medically controlled conditions is preferable to illegal back-alley abortion without proper medical supervision	pos
Certain restrictions on abortion could be used to form a slippery slope against all abortions	neg
women's lives are lost due to unsafe abortions when abortion is illegal	neg
life begins at conception	pos
Abortion, which would involve the deliberate destruction of life, should be rejected	neg
one must abort a fetus if the continuation of pregnancy might imperil the life of the woman	pos
abortion is justifiable if a continuation of pregnancy might cause the woman severe physical or psychological harm	pos
In all circumstances, it should be the woman's decision whether or not to terminate a pregnancy	pos
Abortion is deemed a fundamental right	pos
A state's ban on partial birth abortion is unconstitutional	neg
induced abortion is the deliberate and unjust killing of the embryo in violation of its right to life	neg
the law should not criminalize just exercises of the right to control one’s own body	pos
criminalizing abortion will lead to the deaths of many women through ‘back-alley abortions	neg
the embryo has a right to life	pos
abortion is wrong because it deprives the embryo of a valuable future	neg
deliberate abortions are seriously immoral	neg
the fetus has a right to life	pos
it should be illegal for governments to regulate abortion	neg
"the state has an ""important and legitimate interest in protecting the potentiality of human life"	pos
"while the state has an interest in protecting the fetus ""at some point"", this interest cannot override that of the pregnant woman"	neg
abortion is morally wrong	neg
while the fetus is innocent and biologically human, it is not a person with a right to life	neg
abortion involves unjust discrimination against the unborn	neg
"deliberate abortions are placed in the ""same moral category"" as killing an innocent adult human being"	neg
having an abortion is equivalent to consciously taking the risk of killing another	neg
Abortion is considered to be morally wrong	neg
A state law banning certain forms of abortion is unconstitutional	neg
D&X would be safer and would involve fewer risks for the women	pos
D&X abortions are never medically necessary	neg
working parents wish their children to be supervised	pos
children need the 2–3 months off to relax and also to take a break from other childhood stresses associated with school	pos
Multitrack schedules reportedly bring many benefits to schools that use them	pos
for every three multitrack schools, one less school must be built	pos
students’ attitudes towards school did significantly increase as they spent more time on a year-round schedule	pos
Students who attend year-round school say that their calendar is more balanced than their peers who have a typical school calendar	pos
year-round schools showed a substantial gain in academic achievement for at-risk, low performing students	pos
More frequent, short breaks provide struggling students more time for help	pos
parents are in favor of the year-round schedule	pos
The year round schedule provides more opportunities for family vacations	pos
If schools are open for longer the operating and maintenance costs may increase	neg
Year round schooling may create difficulties for teens to be able to maintain part-time or summer job	neg
Students with attention learning disabilities may experience difficulties with longer school days	neg
Students that attend year round schooling may miss out on experiences	neg
welfare empowers individuals	pos
Welfare breeds dependence on government aid	neg
Welfare only breeds dependence on the government	neg
welfare has demonstrated some proven effects for helping impoverished families	pos
foreign aid is seen to be serving the interests of the donor more than the recipient	neg
Subsidies may distort markets	neg
subsidies may distort the market	neg
Subsidies produce inefficiencies	neg
Subsidies are inefficient	neg
Welfare reduces poverty	pos
Welfare sustains or even creates poverty	neg
poverty decreases after countries adapt welfare programs	pos
welfare creates a dependence	neg
Welfare makes an incentive to not find work	neg
welfare not only increases poverty but also increases other problems	neg
Safety nets redistribute income to the poorest and most vulnerable, with an immediate impact on poverty	pos
Safety nets enable households to make productive investments in their future that they may otherwise miss	pos
CCT Programs have been proved to be very well-targeted and effective	pos
CCT Programs are efficient tools for reducing poverty and inequality	pos
Subsidies guarantee access to essential commodities at prices that consumers can afford	pos
Subsidies tend to be expensive and regressive	neg
Subsidies may distort production incentives	neg
Safety nets  protect households facing hard times from falling into deeper poverty and help them manage risk	pos
Safety nets protect households facing hard times from falling into deeper poverty and help them manage risk	pos
Safety nets can provide households with a cushion to invest resources more efficiently	pos
less stratified economies are more socially just	pos
the rich have an obligation to assist the poor, thus creating a more financially egalitarian society	pos
the rich exploit the poor or otherwise gain unfair benefits, and thus should return some of those benefits	pos
a larger middle class benefits an economy by enabling more people to be consumers	pos
economic inequality contributes to crime	neg
a lower rate of redistribution in a given society increases the inequality found among future incomes	neg
wealth and income inequality are a cause of economic crises	neg
Reducing wealth and income inequalities is one way to prevent or ameliorate economic crises	pos
Governmental redistribution of wealth improves social stability	pos
there is no encouragement of those receiving aid to resume working	neg
redistribution of legitimately obtained property cannot ever be just	neg
redistribution tends to benefit those with political clout to set spending priorities more than those in need	neg
poverty, once started, is likely to continue unless there is outside intervention	pos
the welfare state has produced a generation of dependents who, instead of working, rely solely upon the state for income	neg
Social welfare creates dependence to the state	neg
Higher levels of economic inequality tend to intensify social hierarchies and generally degrade the quality of social relations	neg
Economic inequality is thought to reduce distributive efficiency within society	neg
a society with more equality will have higher aggregate utility	pos
in societies where inequality is lower, population-wide satisfaction and happiness tend to be higher	pos
an increased gap between rich and poor increases the incentives for competition and innovation within an economy	pos
inequality is harmful for economic development	neg
Redistributive policies have an adverse effect on investment and economic growth	neg
economic equality is necessary for political freedom	pos
when there is economic inequality then political inequality is assured	neg
a certain amount of redistribution would be justified	pos
without redistribution, one generation's successful individuals would become the next generation's embedded caste	pos
social justice requires redistribution of high incomes and large concentrations of wealth in a way that spreads it more widely	pos
economic inequality reduces social cohesion and increases social unrest	neg
economic inequality invariably translates to political inequality	neg
The availability of government funds leads to tensions within the community	neg
Because current science can't figure out exactly how life started, it must be God who caused life to start	pos
there are insufficient grounds to assert authoritatively that any supreme being does not exist	neg
acknowledgment of God or the gods is a major factor in motivating people towards moral behavior	pos
Atheism has been criticized as a faith in itself	neg
atheism systematically influences people to do bad things	neg
The existences of a god and of evil are logically incompatible	neg
God cannot exist with, or would want to prevent, all evils	neg
An omniscient, wholly good being would prevent the occurrence of any intense suffering	neg
belief in a higher being is the product of fear	neg
we do not need God to explain things	neg
the most immoral acts in human history were performed by atheists	neg
the human race no longer needs religion	neg
all attempts to reconcile faith with science and reason are consigned to failure	neg
God, the beginning and end of all, can, by the natural light of human reason, be known with certainty from the works of creation	pos
unproven religious propositions deserve as much disbelief as all other unproven propositions	neg
atheists are quick to believe in God in times of crisis	neg
God and other religious beliefs are human inventions	neg
belief in God and religion are social functions, used by those in power to oppress the working class	neg
the idea of God implies the abdication of human reason and justice	neg
The idea of God is the most decisive negation of human liberty	neg
The idea of God necessarily ends in the enslavement of mankind	neg
denying the existence of a god leads to moral relativism, leaving one with no moral or ethical foundation	neg
Denying the existence of a god renders life meaningless and miserable	neg
Religion is viewed as a human invention used to frighten people into following moral order	neg
atheism is a superior basis for ethics	pos
religions provide a net benefit to individuals and society	pos
religions can be harmful	neg
reliance on divine authority lends itself to authoritarianism and dogmatism	neg
God must exist to give force to moral obligations	pos
objective moral truths and the binding nature of obligations suggests a high power to enforce them, regarded as God	pos
only the existence of God as orthodoxly conceived could support the existence of moral order in the world	pos
A natural moral order requires the existence of God as orthodoxly conceived, so god must exist	pos
there is not good argument for God's existence that arises from pure reason alone	neg
all moral thought requires the assumption that God exists	pos
theists are able to offer justification for morality, while atheists are not	pos
the natural is all that exists	pos
the universe can be explained without any reference to the supernatural	neg
God exists and this can be proven	pos
none of the arguments for God's existence are compelling	neg
life and the universe were created by a deity	pos
faith − belief that is not based on evidence − is one of the world's great evils	neg
atheism is evidence of a healthy, independent mind	pos
nature is all there is	pos
everything in the Universe has a purpose, which must have been caused by God	pos
everything in the Universe follows laws, which must have been created by God	pos
arguments for the existence of God show insufficient reason to believe	neg
The universe includes ideas not perceptible to mankind (or not always perceptible), and there must therefore exist an omniscient superobserver	pos
"there was a ""first cause"", or ""prime mover"" who is identified as God"	pos
the universe's order and complexity are best explained by reference to a creator God	pos
certain features of the universe and of living things are the product of an intelligent cause	pos
basic facts, such as humanity's existence, are best explained by the existence of God	pos
ethics, and other serious matters do not make sense in the absence of God	neg
atheistic arguments must ultimately refute themselves if pressed with rigorous consistency	neg
the theism of people throughout most of recorded history and in many different places provides prima facie demonstration of God's existence	pos
when a person's understanding ponders over the existence of God it encounters nothing but contradictions	neg
natural (non-supernatural) theories adequately explain the development of religion and belief in gods	pos
The argument for the existence of god is a logical fallacy	neg
the concept of an omnipotent entity is logically contradictory	neg
things cannot exist without creators	pos
an omnipotent and omniscient being would not have any reason to act in any way, specifically by creating the universe	neg
if, when asked for, there is no visible help from God, there is no reason to believe that there is a God	neg
an unchanging God cannot be the source of an ever changing world	neg
the idea of God is inconceivable and self-contradictory	neg
a perfect God can have no need to create a world	neg
a benevolent deity ought to create only happy creatures, not an imperfect world like the real world	neg
The evidence allegedly proving the existence of God is insufficient	neg
"God's existence ""can be known with certainty from the created world by the natural light of human reason"	pos
God's existence can be demonstrated	pos
all human experience and action (even the condition of unbelief, itself) is a proof for the existence of God	pos
there is insufficient reason to believe that any gods exist	neg
the existence of some or all gods is logically impossible	neg
The combination of attributes which God may be asserted to have are logically contradictory	neg
there are no good reasons and no credible grounds for believing that gods exist	neg
humanity would be better off without religion or belief in God	neg
Faith is divisive and dangerous	neg
atheism is not a recipe for despair but just the opposite	pos
Atheism is life-affirming in a way that religion can never be	pos
religion does more harm than good	neg
all phenomena could be understood as resulting from purely natural causes	pos
religion was born of fear and ignorance	neg
Religions require beliefs that are irrational	neg
religious beliefs and traditions lack scientific or rational foundations	neg
Religions often posit facts that are contradicted by scientific evidence	neg
Religions teachings are outdated in comparison with modern Western morals	neg
Religions have promoted facts and histories that are contradicted by science	neg
theist religions and their holy books are not divinely inspired, but instead are fabrications of non-divine human individuals	neg
there are reasonable arguments supporting the existence of God	pos
religious belief is a delusion	neg
religion is nothing more than a social construct that primitive humans evolved	neg
the need for explaining life and death can be met by science and philosophy	pos
"atheism was responsible for ""some 20th century atrocities"	neg
theistic religions devalue human compassion and morality	neg
religion is a positive civilizing influence on society	pos
the effect of religious belief, is positively harmful	neg
There is evidence for the existence of a God	pos
evolution can explain the apparent design in nature	pos
"Natural selection and similar scientific theories are superior to a ""God hypothesis""—the illusion of intelligent design—in explaining the living world and the cosmos"	pos
evolution by natural selection can explain apparent design in nature	pos
the designer hypothesis immediately raises the larger problem of who designed the designer	neg
the theory of a universe without a God is preferable to the theory of a universe with a God	pos
religion is needed to make us behave morally	pos
Religion fills a much needed gap	pos
religion is socially dangerous	neg
The God hypothesis is considered inferior to evolution by natural selection as explanations for the complexity of life	neg
where design fails to explain complexity, evolution by natural selection succeeds	pos
The theory of natural selection is much simpler than the theory of the existence of such a complex being, and thus preferable	pos
God is improbable	neg
a creator of a universe with such complexity would have to be complex and improbable	neg
there must be a first cause, which can be given the name God	pos
something caused the Universe to exist, and this First Cause must be God	pos
existence must be due to an agent cause	pos
the existence of the Universe requires an explanation, and the creation of the Universe by a First Cause, generally assumed to be God, is that explanation	pos
a god created the Universe	pos
Normal aging is associated with a decline in various memory abilities in many cognitive tasks	neg
separation of older people from active roles in society is normal and appropriate	pos
Separation of older people from active roles in society benefits both society and older individuals	pos
the more active elderly people are, the more likely they are to be satisfied with life	pos
older workers are more expensive than younger ones	neg
Older workers lack up-to-date skills	neg
Older people are seen as a group that acts as more of a cost than an asset to the company	neg
The older generation workers often require more benefits from the company due to their age	neg
the age at which retirement is mandated is often somewhat arbitrary and not based upon an actual physical evaluation of an individual person	neg
The practice is viewed as a form of age discrimination, or ageism	neg
it is unlawful to discriminate against a person because of his/her age	neg
Identification requirements may heighten the opportunities for confusion and voter intimidation	neg
Identification requirements may reduce rather than expand the electorate	neg
Voter identification laws could suppress the turnout by voters	neg
Presenting photographic IDs is a minor inconvenience when weighed against the possibility of ineligible voters affecting elections	pos
photo ID requirements disproportionately affect minority and elderly voters	neg
Photo identification is necessary to prevent widespread voter fraud	pos
Photo identification would decrease voting	neg
The danger of voter fraud threatens the integrity of the entire electoral process	neg
Legislation to impose restrictive photo ID requirements has the potential to block millions of eligible American voters, and thus suppress the right to vote	neg
Procedures for acquiring an ID are too burdensome and costly for some low income or elderly voters	neg
military service provides job skills	pos
personal and technical skills learned in the military will improve later employment prospects in civilian life	pos
leadership skills acquired during military training can absolutely enhance one’s chances for success in corporate life	pos
in the case of a mandatory draft members of the U.S. Congress would be much less likely to authorize an unnecessary war	pos
bringing back the draft would remedy the social disparity	pos
a draft would make the military more representative of the American public at large	pos
Fairness dictates that the sons and daughters of the white middle and upper classes share the burden of war	pos
some service is better than none at all, bringing citizens in contact with their military	pos
the abolition of the draft would lead to recruitment shortages even for higher ranking positions	neg
Considerable savings in defence  spending from abolishing the draft are expected	pos
professional armed forces can be more expensive than a draft-based military	neg
the draft was simply anachronistic	neg
The draft obliged male citizens to pay society back through their military or civilian service	pos
Conscription violates individual rights	neg
Conscription represents slavery and involuntary servitude	neg
Of all the statist violations of individual rights in a mixed economy, the military draft is the worst	neg
The military draft is an abrogation of rights	neg
The military draft negates man’s fundamental right—the right to life	neg
the very conception of a just government in its duty to the citizen includes the reciprocal obligation of the citizen to render military service in case of need	pos
in a cost-to-benefit ratio, conscription during peace time is not worthwhile	neg
Months or years of service amongst the most fit and capable subtracts from the productivity of the economy	neg
The work effort of the conscripts is effectively wasted	neg
Professionally-skilled conscripts are difficult to replace in the civilian workforce	neg
Every soldier conscripted in the army is taken away from his civilian work, and away from contributing to the economy which funds the military	neg
It is the right and privilege of every citizen to participate to the defense of the whole society	pos
Mandatory military and national service are considered as ways of instilling maturity in young adults	pos
conscription would not provide adequate protection for the rights of conscientious objectors	neg
adequate military strength could be maintained without having conscription	neg
the draft is fundamentally unfair	neg
The draft has been perceived by some as unfairly targeting the poor and lower middle classes	neg
It is less likely that a republic with conscription would engage in preemptive wars	pos
the draft should be reinstated to make the military more equal	pos
"the draft ""does bring people from all quarters of our society together in the common purpose of serving"	pos
Care work is acknowledged as central to economic development and human well-being	pos
unpaid domestic work is just as valuable as paid work	pos
domestic labor is work	pos
Care work is essential to human well-being	pos
care work is directly related to the health of a society as well as to the economic development of that society	pos
the household sector is a wealth spender, and not a wealth creator	neg
the household sector plays a very important role in wealth creation	pos
Women's jobs in the home are not part of any market	neg
the household does not form wealth	neg
the quality of care may decrease in response to the call for profit-making and efficiency	neg
property rights encourage their holders to develop the property	pos
property rights encourage their holders to develop their property or generate wealth	pos
interference by the state over the centuries in property ownership has had dire consequences for justice as well as for economic productivity	neg
Patents provide incentives for economically efficient research and development	pos
patents facilitate and encourage disclosure of innovations into the public domain for the common good	pos
If inventors did not have the legal protection of patents, in many cases, they would prefer or tend to keep their inventions secret	pos
Awarding patents generally makes the details of new technology publicly available	pos
when a patent's term has expired, the public record ensures that the patentee's idea is not lost to humanity	pos
Patents are criticised as inonsistent with free trade	neg
copyright law protects corporate interests while criminalizing legitimate use	neg
Copyright law is fair and just	pos
patent and copyright laws support in fundamental and thoroughgoing ways the expansion of the range of creative human activities that can be commodified	pos
intellectual property is desirable because it encourages innovation	pos
creators will not have sufficient incentive to invent unless they are legally entitled to capture the full social value of their inventions	pos
intellectual property rights are essential to maintaining economic growth	pos
Intellectual property laws give statutory expression to the moral and economic rights of creators in their creations	pos
Intellectual property laws promote, as a deliberate act of Government policy, creativity	pos
Intellectual property laws encourage fair trading which would contribute to economic and social development	pos
effective enforcement of intellectual property rights is critical to sustaining economic growth	pos
A positive correlation between the strengthening of the IP system and subsequent economic growth was found	pos
IP can be a disincentive to innovation	neg
Intellectual property rights promote public welfare	pos
To violate intellectual property is no different morally than violating other property rights	neg
allowing property rights in ideas and information creates artificial scarcity	neg
Allowing property rights in ideas and information infringes on the right to own tangible property	neg
Patents and copyrights are the legal implementation of the base of all property rights: a man's right to the product of his mind	pos
intellectual property laws can actually hinder innovation	neg
Patents divert resources from research and development to patent filing and lawsuits	neg
the only way that intellectual property rights can be implemented is by limiting others' physical property rights	neg
prohibiting people from using, reproducing, and trading copyrighted material is an infringement of freedom of speech	neg
one cannot own information without owning other people	neg
the patent monopoly..consists in protecting inventors..against competition for a period long enough to extort from the people a reward enormously in excess of the labor measure of their services	neg
The allegedly absurd lengths that copyright enforcement is taken to have hindered the ability of consumers to buy the products they want	neg
all information should be freely distributed and unrestricted	pos
granting developers temporary monopolies over their works encourages further development and creativity	pos
copyright has never been of net benefit to society	neg
Copyright serves to enrich a few at the expense of creativity	neg
copyright is invalid because, unlike physical property, intellectual property is not scarce	neg
Copyright law is obsolete	neg
The cost of trying to enforce copyright is unreasonable	neg
Copyright law is seen as preventing or slowing human progress	neg
without an intellectual property rights regime, authors would have no incentive to further create	pos
artists cannot produce new works without an economic incentive	pos
copyright drives the economy by compelling creativity	pos
Copyright is a fundamental right for both creators and consumers	pos
all proposed alternatives to copyright protection do not allow for viable business models	neg
content creators would not have incentive to produce their products if they cannot be guaranteed payment	pos
Patents are obstructing research	neg
Patents are critisized as state-granted monopolies inconsistent with free trade	neg
Patents may hinder innovation	neg
Patents give rise to troll entities	neg
intellectual property rights may become so fragmented that, effectively, no one can take advantage of them	neg
Intellectual property is viewed as a necessary way of incentivising the creation of new creative works	pos
in the absence of intellectual property protections such as copyright and patents, various types of intangible assets would be under-produced	pos
copyright remains the fundamental way by which authors, sculptors, artists, musicians and others can fund the creation of new works	pos
without a significant period of legal protection of their future income, many valuable books and artworks would not be created	pos
Without a feasible way to recoup investments of creative time through copyright, there would be little economic incentive to produce	pos
The present system of strong copyrights has been largely successful in financing the creation and distribution of a wide variety of works	pos
the very concept of copyright has never benefited society	neg
The very concept of copyright has always served simply to enrich a few at the expense of creativity	neg
the current (international) copyright system undermines its own goal	neg
quality works can be created even in the absence of a copyright-enforced monopoly rent	neg
Copyright can be used to stifle political criticism	neg
The copyright system has made and continues to make a valuable even essential contribution to the creation and dissemination of works	pos
Renewable energy is sustainable in its production	pos
Wind power is an intermittent energy source	neg
integrating wind energy into the utility grid can be problematic	neg
Electricity generated from wind power can be highly variable	neg
predictability of wind plant output remains low	neg
the non-dispatchable nature of wind energy production can raise costs	neg
peak wind speeds may not coincide with peak demand for electrical power	neg
The production of zero carbon electricity at the wind farm is expected to reduce emissions of carbon dioxide	pos
"wind power ""cannot be relied upon to provide significant levels of power"	neg
Wind power is rated as the cleanest source of renewable energy	pos
wind farms are necessary to meet current and future energy needs	pos
Compared to the environmental impact of traditional energy sources, the environmental impact of wind power is relatively minor	pos
Wind power emits no air pollution	pos
Wind power consumes no fuel and no water	pos
Producing electricity from wind reduces the consumption of fossil fuels and therefore leads to emissions savings	pos
Wind turbines do not consume fuel or produce pollution during normal operation	pos
Wind farms have a smaller footprint than other forms of energy generation	pos
wind farms will damage tourism	neg
Wind turbines may cause physiological problems	neg
people living near wind power facilities are increasingly complaining of health problems	neg
Wind farms are causing annoyance and ill health in people	neg
Wind power is a product with no hidden costs and economically the most inexpensive form of energy production	pos
The use of wind power reduces the necessity for importing electricity from abroad	pos
Production of wind power does not release any pollutants	pos
wind power does not pose a threat to people or the environment	pos
Wind power has poor capacity contribution	neg
the environmental effects of wind power are relatively minor	pos
Wind power consumes no fuel	pos
Wind power has gained very high social acceptance	pos
Wind energy is a clean energy source	pos
Wind energy does not emit greenhouse gases or carbon dioxide	pos
Many find wind turbines to not be very aesthetically pleasing and consider them to be an eyesore	neg
Wind turbines have the potential to have adverse effects on tourism	neg
Wind power is a proven and reliable technology	pos
The operating costs are relatively low, with each additional unit of wind power costing very little to produce	pos
wind energy is one of the most cost efficient sources of renewable energy	pos
A wind farm has one of the lowest environmental impacts of all energy sources	pos
There is very little emission or pollution produced by a wind farm's operation	pos
wind power produces a net decrease in greenhouse gas emissions and air pollution	pos
An important limiting factor of wind power is variable power generated by wind farms	neg
the environmental impact of wind power is relatively minor	pos
Wind farms can interfere with ground radar systems	neg
Wind-generated power is a variable resource	neg
"Wind power is ""highly non-dispatchable"	neg
A wind farm is highly reliable	pos
the power output from wind varies	neg
wind power is dependent on weather systems	neg
"wind must be backed by an equal amount of ""back-up capacity"	neg
every wind turbine must be backed up by reliable power	neg
The total amount of available power from the wind is considerably more than present human power use from all sources	pos
Wind power, as an alternative to fossil fuels, is plentiful	pos
Wind power produces no greenhouse gas emissions during operation	pos
Wind power uses little land	pos
any effects on the environment from wind power are generally much less problematic than those of any other power source	pos
The total amount of economically extractable power available from the wind is considerably more than present human power use from all sources	pos
variability can present substantial challenges to incorporating large amounts of wind power	neg
the non-dispatchable nature of wind energy production can raise costs for regulation	neg
Wind power has low ongoing costs	pos
Wind is estimated to be more expensive than other sources	neg
The presence of wind energy can reduce costs for consumers	pos
Wind farms 'ruin the landscape'	neg
Wind projects revitalize the economy of rural communities	pos
the unpredictable intervals of near-zero output render windpower unsuitable as a base generating capacity	neg
A modern wind farm has one of the lowest environmental impacts of all energy sources	pos
There are no emissions or pollution produced by a modern wind farm's operation	pos
wind power can help to reduce energy imports	pos
wind power is the most expensive energy generating technology being considered for large scale deployment	neg
wind power can improve energy security	pos
wind power will produce jobs and other forms of economic benefits	pos
Wind power development cuts dependence on fossil fuels	pos
Wind power development creates jobs	pos
wind facilities do not have full control over the times and quantities of their electricity output	neg
biodiversity is inherently valuable	pos
Diverse ecosystems are typically more productive than non-diverse ones	pos
human economic productivity is largely reliant on Earth's ecosystems	pos
Biodiversity is a source of economic wealth	pos
any actions which negatively affect the living systems of which we are a part, adversely affect us as well	neg
all species have inherent value	pos
each organism has a purpose and a reason for being	pos
The cost of repairing damaged ecosystems is considered to be much higher than the cost of conserving natural ecosystems	pos
As long as species have been evolving, species have been going extinct	pos
The loss of native species is seen as a loss to ecotourism	neg
People who live close to nature can be dependent on the survival of all the species in their environment	pos
"since species become extinct ""all the time"" the disappearance of a few more will not destroy the ecosystem"	pos
nature has an intrinsic value	pos
rapid rates of biodiversity loss threatens the sustained well-being of humanity	neg
species are irreplaceable components of the global ecosystem	pos
Species richness and genetic biodiversity contributes to and engenders ecosystem stability	pos
wealth of biodiversity is important for future generations	pos
Conservation is vital for future study	pos
biological richness is an unmeasurable aesthetic that may be developed into commercial recreational attractions	pos
Research on natural processes can only occur if habitat is preserved and organisms continue to thrive	pos
The conservation of biological diversity is an integral part of the development process	pos
there is a threat of significant reduction or loss of biological diversity	neg
like humanity, the living environment as a whole has the same right to live and flourish	pos
the right of all forms [of life] to live is a universal right	pos
All life has intrinsic value	pos
Other life-forms warrant our respect, whether or not they are of immediate benefit to us	pos
we have a responsibility to act as custodians for nature	pos
More biologically diverse communities appear to be more productive	pos
More biologically diverse communities appear to be more stable	pos
there are direct economic consequences of losing diversity in certain ecosystems and in the world as a whole	neg
diverse ecosystems actually resist invasion and disease better than their less diverse equivalents	pos
the indirect effects of losing many species as well as the diversity of ecosystems in general are enormous	neg
When biodiversity is lost, the environment loses many species that provide valuable and unique roles to the ecosystem	neg
The environment and all its inhabitants rely on biodiversity	pos
Any efforts to protect the world’s remaining natural habitat and biodiversity will compete directly with humans’ growing demand for natural resources	neg
Earth's surviving biodiversity provides resources for increasing the range of food and other products suitable for human use	pos
Biodiversity is known to have an important role in reducing disaster risk	pos
Biodiversity provides critical support for drug discovery and the availability of medicinal resources	pos
Biodiversity has been critical to advances throughout the field of bionics	pos
Biodiversity is important to the security of resources	pos
biodiversity has intrinsic aesthetic and spiritual value to mankind	pos
Biodiversity supports many ecosystem services	pos
Biodiversity is directly involved in water purification	pos
Loss of biodiversity results in the loss of natural capital that supplies ecosystem goods and services	neg
the state should provide citizens their demands in order to achieve people's well-being	pos
Austerity programs tend to have an impact on the poorest segments of the population	neg
rather than 'punish' the banks and others truly responsible for the crisis, the government is instead 'punishing' regular people for the 'crimes' of others	neg
austerity measures tend to be counterproductive	neg
austerity simply depresses economic growth	neg
austerity can engender deflation which inflates existing debt	neg
government austerity can result in economic expansion	pos
Austerity programs tend to have an adverse impact on the poorest segments of the population	neg
austerity measures tend to depress economic growth	neg
Some of the austerity measures are irrational	neg
negative impact of tighter fiscal policy could offset the positive impact	neg
social disruption could have a significantly negative impact on investment and growth in the longer term	neg
policy makers consistently underestimated the disastrous effects of rigid spending cuts on economic growth	neg
Short-term sacrifices are necessary for long-term success	pos
Governments borrowed too much, now they're paying the price, and fiscal austerity is the only answer	pos
government should always run a balanced budget	pos
deficit spending is always bad policy	neg
government deficits are inflationary	neg
deficit spending may create inflation	neg
an increase in government spending will lead to inflation	neg
most guns are in the hands of people who are unlikely to misuse them	pos
the right to bear arms is absolute and unqualified	pos
Americans have an individual right described in the Second Amendment to possess firearms	pos
gun ownership is a civil liberty	pos
citizens need to arm themselves to safeguard political liberties against threats by the government	pos
it would be of no use to forbid law-abiding citizens to own legal registered guns in accordance to the law	neg
Regions where gun ownership is widespread are the ones with the smallest number of gun-related deaths	pos
guns are dangerous for society	neg
Guns' only reason to exist is to harm others	neg
guns are needed for personal security	pos
There are significant correlations between gun ownership and gun-related suicide and homicide rates	neg
the access to guns leads to more violence	neg
laws which make it easier for law-abiding citizens to get a permit to carry a gun in public places, cause reductions in crime	pos
allowing law-abiding citizens to carry concealed firearms deters crime	pos
Gun laws generally have no significant effect on violent crime rates or suicide rates	neg
Self-defense is considered to be a fundamental and inalienable human right	pos
The prohibition of an effective means of self defense is considered to be unethical	neg
laws that forbid the carrying of arms .. disarm only those who are neither inclined nor determined to commit crimes	neg
Gun ownership is seen as a civil right	pos
gun possession is a civil right	pos
an armed citizens' militia can help deter crime and tyranny	pos
There are substantial correlations between gun ownership and gun-related suicide and homicide rates	neg
easier access to guns lead to more violence	neg
Laws that forbid the carrying of arms make things worse for the assaulted and better for the assailants	neg
Laws that forbid the carrying of arms serve rather to encourage than to prevent homicides	neg
The personal right to bear arms is thought to be a paramount right by which other rights could be protected	pos
gun possession is a fundamental civil right	pos
"the people have a right to ""keep and bear arms"" as a protection from the government"	pos
"the right to bear arms is necessary for the citizens to protect themselves from the ""tyranny in government"	pos
an armed citizenry is the population's last line of defense against tyranny by their own government	pos
arms allow for successful rebellions against tyranny	pos
a well-armed citizenry prevents crime	pos
making civilian ownership of firearms illegal would increase the crime rate	neg
increased gun ownership leads to higher levels of crime	neg
Armed citizens play their role in crime control	pos
criminals ignore gun control laws	neg
Criminals are effectively deterred by armed intended victims	pos
people who keep a gun at home increase their risk of homicide	neg
The possibility of getting shot by an armed victim is a substantial deterrent to crime	pos
the likelihood that a death will result is significantly increased when either the victim or the attacker has a firearm	neg
criminal use of guns is far more common than self-defense use of guns	neg
more guns can reduce crime	pos
limiting access to guns by law-abiding people makes them more vulnerable to armed criminals	neg
Right-to-carry laws serve as a deterrent against crime	pos
guns provide some level of protection against criminality and tyranny	pos
widespread gun ownership is protection against tyranny	pos
gun control laws are effective in reducing gun-related accidents and crime	pos
gun control laws are ineffective in reducing gun-related accidents and crime	neg
the Second Amendment guarantees an individual's right to own a firearm	pos
fewer restrictions on handguns will result in increasing numbers of injuries and deaths	neg
Defensive use of guns is both common and effective in preventing injury and property loss	pos
gun bans would increase injuries and deaths	neg
Corruption and economic crimes undermine the value of democracy	neg
Bribery in bureaucracy has been viewed as a reason for higher cost of production of goods and services	neg
Bribery encourages rent seeking behaviour	neg
the bribery of government officials impedes the democratic process	neg
The bribery of government officials may interfere with good government	neg
In some cases where the system of law is not well-implemented, bribes may be a way for companies to continue their businesses	pos
Corruption poses a serious development challenge	neg
Corruption undermines democracy and good governance	neg
Corruption undermines the legitimacy of government and democratic values	neg
corruption increases the cost of business	neg
corruption reduces costs by cutting bureaucracy	pos
Availability of bribes can induce officials to contrive new rules and delays	neg
corruption inflates the cost of business	neg
Corruption generates economic distortions	neg
Corruption reduces the quality of government services and infrastructure	neg
In some countries the culture of corruption extends to every aspect of public life, making it extremely difficult for individuals to stay in business without resorting to bribes	neg
Corruption adds to economic inequality	neg
Corruption favors the most connected and unscrupulous, rather than the efficient	neg
Bribes lead to a misdirection of resources	neg
Corruption is never a better option to honest public policy	neg
Corruption distorts and retards development	neg
"corruption may act as a ""lubricant"" to ""loosen up"" the bureaucracy and facilitate commercial exchanges"	pos
sanctions are designed to pressure the regime to enter into dialogue with the demcoracy movement	pos
Burma's rulers continue to defy the world's just demand to stop their vicious persecution	neg
the government wants to engage again in constructive dialogue	pos
economic sanctions and political pressure by Western countries on Burma was counter-productive and futile	neg
economic sanctions and political pressure on the Burmese military regime remain the only feasible policy to achieve a restoration of democracy and human rights in Burma	pos
efforts to sanction Burma were useless	neg
the best way to go is through engagement and encouragement	pos
constructive engagement with the Burmese junta has failed	neg
The use of force is the last thing Burma needs right now	neg
American-led sanctions have had adverse effects on the civilian population	neg
the government has embarked on a series of reforms toward liberal democracy	pos
the military regime in Burma is one of the world's most repressive and abusive regimes	neg
the Burmese regime has marked certain ethnic minorities such as the Karen for extermination	neg
since the transition to new government in August 2011, Burma's human rights record has been improving	pos
the American-led sanctions have had adverse effects on the civilian population	neg
Oil sands extraction is generally held to be more environmentally damaging than conventional crude oil	neg
The production of bitumen and synthetic crude oil emits more greenhouse gases than the production of conventional crude oil	neg
oil sands industry has been identified as the largest contributor to greenhouse gas emissions growth in Canada	neg
wildlife has been negatively affected by the oil sands	neg
Pipelines are generally the most economical way to transport large quantities of oil, refined oil products or natural gas over land	pos
oil and gas pipelines are an important asset of the economic development of almost any country	pos
The pipeline would present significant adverse effects to certain cultural resources	neg
the new pipeline has been beset with cost overruns	neg
The pipeline's permit was based on a deficient environmental impact statement	neg
the pipeline could pollute air and water supplies	neg
this is the most technologically advanced and safest pipeline ever proposed	pos
the Keystone XL Pipeline undermines the U.S. commitment to a clean energy economy	neg
building this pipeline has the potential to undermine America's clean energy future and international leadership on climate change	neg
this pipeline is a multi-billion dollar investment to expand our reliance on the dirtiest source of transportation fuel currently available	neg
The Keystone XL pipeline would allow the U.S. to increase its energy security and reduce its dependence on foreign oil	pos
there is an extensive overcapacity of oil pipelines from Canada	neg
After completion of the Keystone XL line, oil pipelines to the U.S. may run nearly half-empty	neg
"the pipeline would be ""game over for the planet"	neg
"Israel was ""compelled to continue to take these defensive measures"" to protect more than 200,000 Israelis living under the threat of Palestinian rocket barrages.Militants"	pos
The rocket attacks have caused widespread fear and hardship in Israeli border towns	neg
Israel's right to defend itself is recognized	pos
Israeli military attacks were launched in response to militants firing missiles	pos
Israel's response was excessive	neg
"Israel's attacks were ""more than a holocaust"	neg
Israel intentionally targeted civilians in Gaza	neg
Hamas was willing to renew the cease-fire under the original terms	pos
the firing of rockets at Israel constituted a deliberate attack against the civilian population	neg
the Israeli operation greatly curtailed years of Hamas rocket fire, returning a sense of normalcy to Southern Israel	pos
During Operation Cast Lead, the Israeli Defense Forces did more to safeguard the rights of civilians in a combat zone than any other army in the history of warfare	pos
Israel was widely criticised by human rights groups for using heavy firepower and causing hundreds of civilian casualties	neg
the Israeli military operation was directed at the people of Gaza as a whole	neg
"during the conflict, the Israel Defense Forces ""did more to safeguard the rights of civilians in a combat zone than any other army in the history of warfare"	pos
life in much of southern Israel was paralyzed by Hamas rocket and mortar fire	neg
Israel targeted Palestinian civilians as a matter of policy	neg
it was a war against Palestinian civilians	neg
Palestinian security forces do little or nothing to prevent rocket attacks	neg
the constant threat of impending rocket attacks has caused fear and disrupted the lives of the growing number of Israelis who live within range of such attacks	neg
Israeli citizens in the south have been suffering from rockets being fired at them	neg
Life in the south under rocket barrages had become unbearable	neg
Hamas attacks are violations of basic humanitarian law	neg
The Israeli government's use of force in the Gaza Strip are acts of self-defense	pos
the Israeli Defence Force breached laws of armed conflict by attacking indiscriminately civilians	neg
anything affiliated with Hamas is a legitimate target	neg
Israel's UAV attacks were a violation of International Humanitarian Law	neg
the Israeli soldiers at best failed to protect civilians, and at worst deliberately shot at them	neg
"Israel used ""decisive force to enhance regional deterrence"	pos
during Operation Cast Lead, the IDF did more to safeguard the rights of civilians in a combat zone than any other army in the history of warfare	pos
the psychological effect of the rocket strikes paralyzed life across Israel's south	neg
The government of Israel had a policy of deliberately targeting civilians	neg
it was Israeli government policy to deliberately target citizens	neg
The Gaza war was conducted as a response to rockets fired from the Gaza Strip	pos
"the war was targeted against the ""people of Gaza as a whole"	neg
"Israel’s military assault on Gaza was designed to ""humiliate and terrorize a civilian population"	neg
Israel violated the Fourth Geneva Convention by targeting civilians	neg
Palestinian armed groups committed war crimes and possibly crimes against humanity	neg
The Hamas terror organization is the one who started the war	neg
Hamas has used terrorism for years against Israeli children	neg
The IDF's operations allowed Gazans to resume normalcy	pos
the IDF was forced to deal with the lowest form of terrorists	pos
"disproportionate destruction and violence against civilians were part of a deliberate policy"" by Israel"	neg
Hamas is guilty of war crimes	neg
Israel disproportionately attacked civilians	neg
Israel was acting in self-defence	pos
"the right to self-defence requires that peaceful means are first exhausted before resorting to military force, something Israel ""did not even contemplate doing"	neg
Israelis have been killed by the unlawful rocket and mortar attacks from Gaza	neg
The ongoing Israeli military operation in Gaza resulted in massive violations of human rights of the Palestinian people	neg
Israel's actions on the Gaza Strip must be characterised as war crimes	neg
Israel's right to self-defence is recognized	pos
The right of the Israeli people to a life in peace and security without permanent threat from rocket attacks must be guaranteed	pos
Israel's legitimate right to self-defence is undisputable	pos
Israel's attacks represent a severe and massive violation of the International Humanitarian Law	neg
War has never brought any solution to problems	neg
The repeated firing of rockets by Hamas endangers the lives of both Israeli and Palestinian civilians	neg
the massive and disproportionate attacks by Israel to the Gaza Strip are in violation of international humanitarian law	neg
the military solution won't conduct to peace	neg
Israel has the right to take military action against attacks on locations where its civilians live	pos
it was Hamas that broke the truce	neg
Hamas started the conflict by firing rockets on Israel	neg
No country can just passively accept being fired on	neg
The right of Israel to defend itself against rockets and terrorist attacks is acknowledged	pos
Military action leading to the killing and suffering of civilians, by whomever is carried out, deserves to be condemned	neg
The Israeli air strikes have demanded a disproportionate amount of civilian victims	neg
nothing justifies the suffering inflicted to civilian populations who live trapped in the Gaza strip	neg
The escalation of tensions in the Gaza Strip […] has been triggered by rocket attacks launched by Hamas against innocent Israeli civilians	neg
"Israel's response was ""disproportionate"	neg
Israel's actions in Gaza are both disproportionate and clearly contrary to international humanitarian law	neg
Israel`s unproportionally all-out war on Hamas with a great number of fatalities is an unforgettable human tragedy	neg
Israel's right to protect its citizens is recognised	pos
The disproportionate and excessive use of force displayed by the Israeli government has resulted in numerous casualties	neg
This cycle of violence and retaliation impedes efforts to broker lasting peace in the region	neg
the military operations were a flagrant violation of international humanitarian law	neg
aggression and disproportionate use of force by Israel is unfortunate and only leads to further escalation of violence	neg
the disproportionate use of force by Israel, which causes suffering to the civilian population, can be neither understood nor justified	neg
Israel's right to self defence was acknowledged	pos
"the reaction of the armed forces of Israel was condemned as ""disproportional"	neg
Israel's actions were causing unjustifiable deaths among the civilians	neg
Israel's right to defend itself against attacks from Gaza is recognised	pos
"Israel's bombardment of Gaza ""bears all the hallmarks of war crimes"	neg
The attacks would not contribute to the security of Israel	neg
A large resident population provides opportunities for social interaction	pos
only high rise developments could accommodate the density level of population	pos
Planning policies which increase population densities in urban areas do tend to reduce car use	pos
urban intensification which increases population density will reduce per capita car use, with benefits to the global environment	pos
High-rise blocks became notorious for crime and poverty	neg
apartment buildings have high levels of security	pos
The total cost for the construction of an apartment is much less than the cost invested in the construction of a single house	pos
High-rise buildings cast a significant shadow over nearby buildings, reducing solar energy harvesting	neg
High-rise buildings also cast shadows over public spaces, reducing their amenity value	neg
High-rise structures also pose serious challenges to firefighters during emergencies	neg
Apartment blocks have technical and economic advantages in areas with high population density	pos
In contrast with low-rise and single-family houses, apartment blocks accommodate more inhabitants per unit of area of land they occupy	pos
Apartment blocks decrease the cost of municipal infrastructure	pos
Tower Blocks grew a reputation for being undesirable low cost housing	neg
many tower blocks saw rising crime levels	neg
The way tower blocks are constructed would save money	pos
Many tower blocks experience structural decay	neg
The overbearing design of the tower blocks makes them fearsome and unsociable	neg
Tower blocks may be inherently more prone to casualties from a fire	neg
people living on higher floors cannot escape fires easily and the fire brigade cannot reach the higher floors quickly	neg
Tower blocks can hold thousands of families in a single building	pos
more and more people around the world move into multi-story apartment blocks	pos
single family houses are likely to require much more energy to heat in cold weather than do buildings with shared walls	neg
Single-family houses are part of a much more energy and carbon-intensive lifestyle	neg
consumers prefer lower density neighborhoods	pos
Living in larger, more spread out spaces generally makes public services more expensive	neg
Planning policies that increase population densities in urban areas tend to reduce car use	pos
Increased population density is linked with increased aggression	neg
increased population density encourages crime and anti-social behavior	neg
human beings, while social animals, need significant amounts of social space or they become agitated and aggressive	pos
it is neither necessary nor desirable to create an offence of religious insult	neg
The law against blasphemy complements laws against racial discrimination and incitement to violence	pos
the state has no legitimate interest in protecting any or all religions from views distasteful to them	neg
It is not the business of government in our nation to suppress real or imagined attacks upon a particular religious doctrine	neg
Freedom of expression does not give anyone the licence to insult another's religion or race	neg
humiliation of the values that are held in high esteem by people cannot be justified by the freedom of speech	neg
freedom of speech and disseminating ideas do not amount to the right to insult	neg
there is no place for the offence of blasphemous libel in a society which respects freedom of speech	neg
Anti-blasphemy and religious defamation laws are used to imprison journalists, students and other peaceful political dissidents	neg
Defamation of religions is a modern expression of religious hatred and xenophobia	neg
The 'defamation of religions' concept is used to justify censorship	neg
Blasphemy laws can be used to victimize non-members of, and dissident members of, the state religion	neg
Blasphemy has been condemned as a serious, or even the most serious, sin by the major creeds and Church theologians	neg
blasphemy, which is a sin committed directly against God, is more grave than murder	neg
the offence of blasphemy is a dead letter	neg
the common-law offence of blasphemous libel serves no useful purpose in modern law	neg
The offence of blasphemous libel is believed by some to be contrary to the freedom of speech	neg
The blasphemy law is now a dead letter	neg
freedom of speech cannot be compromised	pos
The responsibility of all governments is to ensure full respect of all religions	pos
the freedom of expression does not justify in any way whatsoever the defamation of religions	neg
freedom of speech ends when sacred values are offended	neg
Freedom of expression is at the core of democracy	pos
The right to freedom of thought and expression, sanctioned by the Declaration of the Rights of Man, cannot imply the right to offend the religious sentiment of believers	neg
In all societies there is a need to show sensitivity and responsibility in treating issues of special significance for the adherents of any particular faith	pos
the blockade is necessary to limit Palestinian rocket attacks from the Gaza Strip	pos
The blockade is considered illegal	neg
the Israeli blockade and closures had pushed the Palestinian economy into a stage of de-development	neg
Even if the blockade is eased it remains illegal under international law	neg
The blockade is a collective form of punishment on a civilian population	neg
The purpose of the blockade is to pressure Hamas into ending the rocket attacks and to deprive them of the supplies necessary for the continuation of rocket attacks	pos
the blockade of the Gaza Strip [among other security and deterrence measures], have brought about a quiet	pos
the blockade is necessary to prevent weapons from reaching Gaza	pos
the consequences of Israel’s failure to maintain the blockade would be “an Iranian port in Gaza, only a few dozen kilometers from Tel Aviv and Jerusalem	neg
"Israel ""could not lift the embargo altogether as long as Hamas remains in control"" of Gaza"	neg
both the blockade and its enforcement are illegal	neg
the blockade is legal	pos
The blockade amounts to a flagrant contravention of international human rights and humanitarian law	neg
The blockade constitutes collective punishment under international law	neg
as the occupying power, Israel has a duty under international law to ensure the welfare of Gaza’s inhabitants	pos
"the blockade of Gaza is causing ""unacceptable suffering"	neg
The blockade is possibly a crime against humanity	neg
the formal economy in Gaza has collapsed since the imposition of the blockade	neg
"the ""restrictions imposed on the civilian population by the continuing blockade of the Gaza Strip amount to collective punishment, a violation of international humanitarian law"	neg
Israel's inhuman blockade of Gaza represents a threat to regional peace and stability	neg
"all that is being achieved through the blockade is to ""enrich Hamas and marginalize even further the voices of moderation"	neg
the blockade actually strengthens Hamas's grip on the economy and on Gaza	neg
Gaza cannot and must not be allowed to remain a prison camp	neg
the blockade on Gaza is neither sustainable nor tenable in its present form	neg
What is going on in Gaza is a humanitarian catastrophe	neg
current Israeli restrictions are counterproductive for Israel's long term security	neg
The situation in Gaza is unsustainable and unacceptable	neg
The naval blockade imposed on the Gaza Strip by Israel conforms to the rules of international law	pos
The naval blockade was imposed on the Gaza Strip lawfully, with Israel complying with the conditions for imposing it	pos
the damage to the civilian population is not excessive in relation to the real and direct military advantage anticipated from the blockade	pos
"Gaza Palestinians ""do not want or deserve to be dependent on humanitarian aid"	neg
"the ""limited trickle"" of items into Gaza continue the effective collective punishment of the civilian population"	neg
The limited trickle of items into Gaza force the counter-productive reliance on tunnels for daily essentials	neg
The Israeli blockade is legal	pos
The Israeli blockade of Gaza is legal	pos
Israel's blockade of the Gaza Strip was described as totally intolerable and unacceptable in the 21st century	neg
Israel's blockade of the Gaza Strip was determined to be legal	pos
The naval blockade was imposed as a legitimate security measure in order to prevent weapons from entering Gaza	pos
The naval blockade's implementation complied with the requirements of international law.	pos
The Gaza blockade is illegal	neg
Israel restricts the ability for the Palestinian authority to exercise control	neg
Israel is inflicting collective punishment on the Gaza population	neg
Gaza was blockaded by Israel in response to the rocket and mortar attacks by Hamas and other militant groups operating inside Gaza	pos
The blockade is harming the Gazan economy	neg
an open seaport in the Gaza Strip endangered the security of Israel	neg
The blockade was called an action outside of international law.”	neg
The situation in Gaza is the direct result of Hamas' rule and priorities	neg
the purpose of the restrictions in import of goods into Gaza are to pressure Hamas, which does not recognise Israel and backs attacks on its citizens	pos
The stated purpose of the blockade was to pressure Hamas into ending the rocket attacks	pos
Israel is not legally responsible for Gaza and not obliged to help a hostile territory beyond whatever is necessary to avoid a humanitarian crisis	pos
the importation curbs are in place to pressure Hamas	pos
A country has the right to decide that it chooses not to engage in economic relations or to give economic assistance to the other party to the conflict	pos
deteriorating economic conditions could result in a derailment of the peace process	neg
Israel's blockade violates the Geneva Conventions	neg
The Gaza blockade inflicted excessive damage to the civilian population in relation to the concrete military advantage expected	neg
As a form of collective punishment, Israel’s continuing blockade of Gaza is a flagrant violation of international law	neg
The Gaza blockade was called collective punishment in contravention of international humanitarian law	neg
blockades are lawful during times of armed conflict	pos
the blockade of a terrorist organization constitutes a collective penalty against civilians	neg
Blockades and other forms of economic sanction are permitted in international law	pos
Israel's blockade of Gaza is illegal	neg
"Gaza Strip is ""an immense concentration camp"	neg
the Israeli blockade of the city had caused the humanitarian situation in Gaza to have reached its worst point since Israel occupied the territory in the 1967 Six-Day War	neg
the world is furious over the blockade on Gaza	neg
The blockade is a crime	neg
It is a crime to continue imposing the blockade against the Gaza Strip	neg
economic recovery is blocked by sweeping restrictions on the movement of goods and people	neg
The absence of a blockade would allow the free passage of arms to the terror-embracing Hamas government	neg
Israel's blockade of Gaza is a direct consequence of attacks launched from within the territory	pos
The blockade is deemed illegal	neg
Humanity cannot continue allowing a city to be slowly strangled	neg
tragedies are completely inevitable if Israel does not listen to the callings of the international community to end the unacceptable and counter-productive blockade of Gaza	neg
tragedies are entirely avoidable if Israel heeds the repeated calls of the international community to end its counterproductive and unacceptable blockade of Gaza	neg
Peace and stability will not come to the region as long as the blockade of Gaza persists	neg
Israeli blockade in Gaza is a violation of international law	neg
The blockade action is a violation of international law	neg
Israel has a right to stop weapons from going into Gaza	pos
Israel is entirely within its rights to prevent Hamas from linking with groups suspected of supplying arms and money to terrorists	pos
Holocaust denial is generally viewed as antisemitic	neg
The primary motivation for most deniers is anti-Semitism	neg
Holocaust denial can inspire violence against Jews	neg
Jews' rights are best protected in open and tolerant democracies that actively prosecute all forms of racial and religious hatred	pos
the work of Holocaust deniers should be protected by a universal right to free speech	pos
laws punishing Holocaust denial are incompatible with the European Convention on Human Rights and the Universal Declaration of Human Rights	neg
education is more effective than legislation at combating Holocaust denial	neg
the laws will make martyrs out of those imprisoned for their violation	neg
Courts consider Holocaust denial a form of spreading hatred and therefore an offence	neg
Holocaust denial is described as an affront to our humanity	neg
It is incorrect to force only one view	neg
Holocaust denial propaganda in all forms has shown to influence the audiences that it reaches	neg
Holocaust denial is a convenient polemical substitute for anti-semitism	neg
"denial legislation imposes ""historical truth as legal truth"	neg
Holocaust denial is the worst form of racism	neg
Denial is among the surest indicators of further genocidal massacres	neg
The denial of such an unimaginable murder of millions cannot simply be accepted as something protected by the freedom of speech	neg
free speech should be applied to everyone regardless of their viewpoints	pos
it is a slippery slope to imprison someone due to the lack of factual accuracy or unpopularity of their opinions	neg
Holocaust denial law restricts the freedom of expression, which is a basic human right	neg
denying or minimising the Holocaust must be seen as one of the acutest forms of racial slandering	neg
Open-source-appropriate technology built in continuous peer-review can result in better quality	pos
"The ""open-source"" model can act as a driver of sustainable development"	pos
Innovations have come, and continue to come, from the open-source world	pos
users should be able to study and change the software they use	pos
"proprietary software commonly contains ""malicious features"	neg
the widely available code for open-source software makes it easier to identify security vulnerabilities	pos
wide availability results in increased scrutiny of the source code, making open source software more secure	pos
proprietary software may include defects or malicious features which would compromise sensitive information	neg
A dependency on the future versions and upgrades for a proprietary software package can create vendor lock-in, entrenching a monopoly position	neg
Free software can result in permanently lower costs compared to proprietary software	pos
With free software, businesses can fit software to their specific needs by changing the software	pos
Free software often has no warranty	neg
FOSS provides high code visibility and the ability to fix security flaws quickly and quietly	pos
The autonomy properties of FOSS make it useful	pos
FOSS cannot be used with other types of software	neg
FOSS applications tend to be much lower in cost than their proprietary equivalents	pos
FOSS applications often provide high levels of functionality with good user acceptance	pos
Open source software promotes learning and understanding	pos
proprietary software is unethical and unjust	neg
The collaborative nature of the open source community creates software that can offer customizability	pos
The open source community promotes the creation of software that is not proprietary, thus resulting in lower costs	pos
Open source provides a flexibility not available in closed products	pos
A major advantage to open source code is the ability for a variety of different people to edit and fix problems and errors that have occurred	pos
open source software promotes better programs and a higher standard of code	pos
software produced in this fashion may lack standardization and be incompatible with various computer applications	neg
Not much support exists for open source software	neg
Open source software will often be less usable	neg
The open source software allows anyone to make changes that will improve it	pos
Open source software can increase speed and flexibility	pos
lesser dependence on proprietary software allows for easier integration of various systems	pos
adoption of open-source software models has resulted in savings	pos
Having more co-developers increases the rate at which the software evolves	pos
open-source software provides solutions to unique or specific problems	pos
One of the greatest barriers facing wide acceptance of open-source software relates to the lack of technical and general support	neg
open-source software is inherently safer	pos
less costs of marketing and logistical services are needed for OSS	pos
The OSS development approach has helped produce reliable, high quality software	pos
Open source software offers the potential for a more flexible technology and quicker innovation	pos
Open source software is said to be more reliable	pos
Open source software is flexible	pos
Open source software is innovative	pos
OSS does not require thinking about commercial pressure that often degrades the quality of the software	pos
open source may allow hackers to know about the weaknesses or loopholes of the software more easily than closed-source software	neg
open source software increases software security	pos
Proprietary software forces the user to accept the level of security that the software vendor is willing to deliver	neg
"The end-user of Open Source code has the ability to change and modify source to implement any extra ""features"" of security they may wish for a specific use"	pos
All people have access to the source code, including potential attackers	neg
"Having a large amount of eyes reviewing code can ""lull a user into a false sense of security"	neg
Tuition fees at private universities tend to be higher than at public universities	neg
Public universities often have much lower tuition than private universities	pos
private universities charge much higher tuition than their public counterparts	neg
privatization consistently improves efficiency	pos
corruption is more prevalent in non-privatized sectors	neg
private market factors can more efficiently deliver many goods or service than governments	pos
governments have few incentives to ensure that the enterprises they own are well run	neg
A state-monopolized function is prone to corruption	neg
Nationalized industries are prone to interference from politicians for political or populist reasons	neg
certain public goods and services should remain primarily in the hands of government in order to ensure that everyone in society has access to them	pos
private entities are more efficiently run	pos
Academics are demoralized by government interference with admissions procedures	neg
all over the world there are excellent universities run independently of the state	pos
It is dangerous to have a university funded by private equity	neg
"if universities are ""to nurture genuinely free and creative academic research"" and ""be the guardians of liberty which a free society needs"" they must be independent of government funding"	pos
academics will only be able to challenge prevailing opinion if they are independent of government funding	pos
Dependence on government funding has had disastrous effects on the higher education sector in continental Europe	neg
ASEAN members have the potential to reap significant benefits	pos
Aside from improving each member state's economies, the bloc also focuses on peace and stability in the region	pos
ASEAN has subscribed to the notion of democratic peace	pos
Through political dialogue and confidence building, no tension has escalated into armed confrontation among ASEAN member countries	pos
ASEAN Way has recently proven itself relatively successful in the settlements of disputes by peaceful manner	pos
ASEAN is criticised for being too soft in its approach to promoting human rights and democracy	neg
"the organisation is ""big on words but small on action"	neg
ASEAN has begun to be less successful at restraining its members and resolving border disputes	neg
the agenda of economic integration would negatively affect industries	neg
The organisation is viewed as imperialistic	neg
Abstinence is the only way to avoid sexually transmitted diseases	pos
education on condom use reduces behaviors that increase the risk of breakage and slippage	pos
no studies have shown abstinence-only programs to result in delayed intercourse	neg
parents want their children to receive comprehensive sexuality education including condom use	pos
condom-promotion programs encourage promiscuity	neg
educating children about sex can encourage them to engage in it	neg
"The majority of parents reject the so-called ""comprehensive"" sex education approach"	neg
"the importance of the ""wait to have sex"" message ends up being lost when programs demonstrate and encourage the use of contraception"	neg
sexual behavior after puberty is a given, and it is therefore crucial to provide information about the risks and how they can be minimized	pos
abstinence-only sex ed and conservative moralizing will only alienate students	neg
Adolescents who begin having sexual intercourse need to understand the importance of using an effective contraceptive every time they have sex	pos
the comprehensive programs work for youth population across the spectrum	pos
Premarital sex is considered to be morally objectionable	neg
teaching of contraception for school children presume premarital sex from the outset and somewhat imply that such things are morally permissible	neg
Comprehensive curricula fail to teach moral behavior	neg
sex education programs focusing on both abstinence and contraception had a positive effect on teen sexual behavior	pos
Programs that stress abstinence as the only acceptable behavior for unmarried teens delay the initiation of sex	pos
there does not exist strong evidence that any particular abstinence program is effective at delaying sex or reducing sexual behavior	neg
studies of abstinence programs have not produced sufficient evidence to justify their widespread dissemination	neg
"a morality based on sex only within the bounds of marriage is ""healthy and constructive"	pos
Abstinence is the most effective preventative measure against both pregnancy and sexually transmitted diseases	pos
sexual activity outside of the context of marriage is likely to have harmful psychological and physical effects	neg
Denying teens factual information leads to unwanted pregnancies and STIs	neg
abstinence-only programs deprive teenagers of critical information about sexuality	neg
sex education needs to be comprehensive to be effective	pos
Abstinence-only programs have not demonstrated successful outcomes	neg
"abstinence-only sex education programs ""reduce risky sexual behaviours"	pos
Sex education programs focusing on both abstinence and contraception have a positive effect on teen sexual behavior	pos
Abstinence-only programs delay the initiation of sex	pos
abstinence-only sex education leads to the opposite of the intended results by spreading ignorance regarding sexually transmitted diseases and the proper use of contraceptives	neg
Abstinence only sex education does not decrease rates of unplanned pregnancy	neg
abstinence-only education is ineffective	neg
abstinence-only education is motivated by religious teachings, which have no place in the classroom	neg
sex before marriage and at a young age has heavy physical and emotional costs	neg
such programs fail to provide adequate information to protect the health of adolescents	neg
such programs verge on religious interference in secular education	neg
abstinence-only sex education distorts information about contraceptives	neg
Evidence has not supported the effective use of abstinence-only sex education	neg
Abstinence-only sex education does not decrease rates of unplanned pregnancy	neg
abstinence-only-until-marriage programs are ineffective	neg
early sexual activity - whether in or out of a romantic relationship - does far more harm than good	neg
Comprehensive sex education covers abstinence as a positive choice, but also teaches about contraception and avoidance of STIs	pos
all abstinence programs are ineffective	neg
abstinence only sex education is ineffective	neg
Abstinence until marriage is the most effective way to avoid HIV infection	pos
abstinence is the only guaranteed way of avoiding unwanted pregnancies and contraction of STDs	pos
The lack of education on safe sex, whether it’s from parents, schools, or otherwise, is a cause of teenage pregnancy	neg
comprehensive sex education would effectively reduce the number of teenage pregnancies	pos
Comprehensive sex education encourages more and earlier sexual activity	neg
Evidence does not support the use of abstinence only sex education	neg
Providing safe-sex education promotes promiscuity	neg
Abstinence-only programs have no positive effects	neg
sex education is necessary to prepare the young for the task ahead	pos
Countries with conservative attitudes towards sex education have a higher incidence of STIs and teenage pregnancy	neg
broad sex education programs have global benefits	pos
Sex education in school makes it easier for parents to talk to their adolescents about sex	pos
Adolescents want both to talk to their parents about sex and to have comprehensive in-school sex education	pos
abstinence-only programs did not reduce the likelihood of pregnancy	neg
the vast majority of Americans favor broader sex education programs over those that teach only abstinence	pos
open dialogue about physical intimacy and health education can generate more self-esteem	pos
sexual behavior outside of marriage is immoral	neg
Abstinence is 100% effective in preventing pregnancy	pos
Abstinence-only education programs often provide inaccurate information about contraceptives and sexuality	neg
Abstinence-only education will result in decreased rates of teenage pregnancy and STD infection	pos
Abstinence-only sex education programs show an increase in the rates of pregnancy and STDs of a teenage population	neg
Professional medical organizations oppose the sole use of abstinence-only sex education	neg
sexual abstinence confers numerous health benefits	pos
Sexual abstinence diminishes the risk of contracting sexually transmitted diseases	pos
sexual abstinence in teenagers decreases the risk of contracting STDs and having children outside marriage	pos
excessive repression of the sexual instinct leads to an increase in the overall level of aggression in a given society	neg
Education programs which focus exclusively on abstinence have never been shown to delay sexual activity	neg
Sex-abstinence programs do not stop risky sexual behavior, or help in the prevention of unwanted pregnancy	neg
term limits are a way to restore popular control over government	pos
The longer politicians are in office, the more likely they are to rip us off for their own benefit	neg
"term limits force politicians ""to represent the people instead of advancing their own careers"	pos
"voters ""overwhelmingly support term limits"	pos
Term limits refresh the political system, removing legislators who had become career politicians and grown out of touch with their constituents	pos
Term limits reduce the excessive time and attention spent on getting re-elected	pos
Incumbents have too great an electoral advantage	neg
Lawmakers are in gridlock because of becoming locked into entrenched positions over time	neg
Freed from political considerations related to re-election, lawmakers would be more free to vote on the merits	pos
Term limits don't distinguish between good and bad legislators	neg
New lawmakers are more vulnerable to power wielded by lobbyists	neg
Term limits won't affect gridlock, being a quick-fix that ignores complicated problems	neg
Limiting terms deprives voters of the right to choose whom they want in office	neg
The lack of mandatory limits to tenure is regarded as a dangerous defect	neg
contact with the affairs of state is one of the most corrupting of the influences to which men are exposed	neg
The States' have the authority to promulgate flag desecration laws under their general police power to safeguard public safety and welfare	pos
symbolic speech is protected by the First Amendment	pos
Flag burning is protected by the First Amendment	pos
protest involving the physical use of the flag should be seen as a form of protected expression under the First Amendment	pos
Burning the flag is a form of symbolic speech subject to protection under the First Amendment	pos
Symbolic speech is recognized as being protected under the First Amendment as a form of speech	pos
there is a constitutional right to make one's speech as effective as possible	pos
Flag burning is a form of free speech	pos
freedom of expression by non-speech means is commonly thought to be protected under the First Amendment	pos
burning the flag is a very offensive gesture that deserves to be formally outlawed	neg
Americans oppose amending the constitution to outlaw flag burning	neg
Americans oppose a flag desecration amendment	neg
Americans support a flag desecration amendment	pos
Flag burning is constitutionally-protected free speech	pos
Flag burning is protected speech under the First Amendment to the United States Constitution	pos
the First Amendment protects such activity as symbolic speech	pos
The First Amendment reaches non-speech acts	pos
States have a compelling interest in preserving a venerated national symbol	pos
Flag burning tends to incite breaches of the peace	neg
States possess an interest in preserving the flag as a unique symbol of national identity and principles	pos
Desecration of the flag impugns its value as such a unique national symbol	neg
"the ""uniqueness"" of the flag ""justifies a governmental prohibition against flag burning"	pos
"flag burning is ""no essential part of any exposition of ideas"	neg
Flag burning is most likely to be indulged in not to express any particular idea, but to antagonize others	neg
the First Amendment does not guarantee the right to employ every conceivable method of communication at all times and in all places	neg
A majority of Americans support a ban on flag-burning	pos
the Constitution allows states to prohibit the burning of the flag	pos
laws against flag-burning are constitutional	pos
flag-burning is not constitutionally protected	neg
it would be constitutional to ban flag-burning	pos
The flag's status as a special emblem of nationality entitles it to additional protections	pos
the state can prohibit the burning of any item in public	pos
Individuals interested in college football prefer a playoff system to the BCS	pos
Often, the BCS system leads to controversies	neg
Controversies concerning inclusion in the BCS National Championship Game are numerous	neg
Significant support among college football fans for a playoff to replace the BCS is shown	pos
the participants of the BCS National Championship game are decided based upon coaches' and media polls rather than via previous, on-field competition	neg
a playoff format would detract from the importance of the regular season and the intensity of rivalry games	neg
a playoff system would create conflicts with student-athletes' studies	neg
a single loss can potentially end a team's chance at a National Championship or propel some other team into the title game under the current system	neg
Unfair competition is inherent in the structure of the BCS	neg
numerous FBS Conferences have expressed their unwillingness to participate in a play-off system	neg
due to the unique and often esoteric nature of the BCS format, there has been controversy as to which two teams should play for the national championship	neg
Implementation of a playoff system would lead to other, more serious consequences	neg
a team with similar or better arguments to another team can be left out of the BCS despite beating the other team	neg
there are several key advantages that the BCS has over a playoff system	pos
the BCS routinely involves controversy about which two teams are the best in the nation	neg
Markets are regulated to some extent by government in order to correct market failures or to promote social welfare	pos
intervention is necessary to solve market-created externalities	pos
government should intervene to prevent market failure	pos
people should make their own choices with their money	pos
the state often serves dominant business interests, distorting the market to their favor and thus leading to inefficient outcomes	neg
Social inequalities result from free-market outcomes	neg
if everyone is left to their own economic devices instead of being controlled by the state, then the result would be a harmonious and more equal society	pos
Allowing individuals to act without any restrictions will produce the best results	pos
the state has a legitimate role in providing public goods	pos
the free market can damage national traditions	neg
Government intervention is seen as harmful	neg
Financial liberalization and privatization coincide with democratization	pos
private market factors can more efficiently deliver many goods or service than governments due to free market competition	pos
A private company will serve the needs of those who are most willing (and able) to pay, as opposed to the needs of the majority	neg
wages are naturally driven down in free market systems	neg
there is an inherent tendency toward oligolopolistic structures when laissez-faire is combined with capitalist private property	neg
the allocation of goods and services by a market is not efficient	neg
the lack of perfect information and perfect competition in a free market is grounds for government intervention	pos
free markets usually fail to deal with the problem of externalities	neg
the free market is not necessarily free, but weighted towards those who already own property	neg
corrective measures) reduce the overall efficiency of the market economy	neg
corrective policies limit the incentive system of the market	neg
grave imbalances are produced when economic action, conceived merely as an engine for wealth creation, is detached from political action	neg
The freer the market, the more prices will reflect consumer habits and demands	pos
Through free competition between vendors for the provision of products and services, prices tend to decrease, and quality tends to increase	pos
"market economies allow spontaneous order; that is, ""a more efficient allocation of societal resources than any design could achieve"	pos
any attempt to implement central planning will result in more disorder, or a less efficient production and distribution of goods and services	neg
there is a direct relationship between economic growth and economic freedom	pos
government at times has to intervene to ensure competition in large and important industries	pos
only a free market can create healthy competition and therefore more business	pos
The unregulated market is seen as an impractical ideal	neg
free market relationships are considered as structured upon coercion	neg
The free market is believed to self-regulate in the most efficient and just way	pos
virtually all developed countries today successfully promoted their national industries through protectionism	pos
there is a legitimate need for government restrictions on free trade	pos
laissez-faire capitalism creates social evils that harm its citizens	neg
the gains from free trade outweigh any losses	pos
the benefits of free trade outweigh the losses	pos
most of the world's major economies are resorting to protectionist measures as the global economic slowdown begins to bite	pos
by trying to maximize their own gains in a free market, individual ambition benefits society	pos
it is competition between buyers and sellers that channels the profit motive of individuals on both sides of the transaction such that improved products are produced and at lower costs	pos
individual self-interest operating in a competitive market place produces the unique conditions under which a society’s total utility is maximized	pos
free markets, by themselves, often do not lead to what is best	neg
some regulation is required to make markets work	pos
competitive markets do a good job allocating resources	pos
free trade will make society more prosperous	pos
free trade increases the global level of output	pos
the absolute quantity of goods and services produced is highest under free trade	pos
Laissez-faire economic politics and parties permit faster growth	pos
the world can produce and consume more when free trade is allowed	pos
free trade encourages economic interdependence between countries, reducing the likelihood of war	pos
free trade would reduce war	pos
the occurrence of free trade has prevented the outbreak of war	pos
free trade would increase the likelihood of a lasting peace	pos
Free trade can enhance national security	pos
free trade gives optimal economic advantages	pos
free trade hurts developed nations	neg
Throughout the world, forces that many blame on free trade are eroding traditional ways of living and rural cultures	neg
Free trade is generally considered to achieve an overall increase in utility in a society	pos
Free trade promotes peace	pos
having free trade would be a net gain for society	pos
the size of the winnings from free trade are larger than the losses	pos
Protectionism creates poverty	neg
free trade is a large and unambiguous net gain for society	pos
Free trade is colonialism or imperialism in disguise	neg
Free trade allows maximum exploitation of workers by capital	neg
free trade agreements generally do not increase the economic freedom of the poor or the working class, and frequently make them poorer	neg
trade barriers should exist to help poor nations build domestic industries	pos
free trade is a form of colonialism or imperialism	neg
Regulation in markets is rejected as inefficient	neg
having many service providers promotes choice and competition	pos
economic freedom, while itself an extremely important component of total freedom, is also a necessary condition for political freedom	pos
Centralized control of economic activities is always accompanied with political repression	neg
Through elimination of centralized control of economic activities, economic power is separated from political power, and the one can serve as counterbalance to the other	pos
impersonal market forces protect people from discrimination in their economic activities for reasons unrelated to their productivity	pos
The justification for central planning is that the consolidation of economic resources can allow for the economy to take advantage of more perfect information when making decisions regarding investment and production	pos
a centrally planned economy can provide public goods which would not have been available at all, or might require explicit government provision, in a market economy	pos
a market economy prevents long-term surpluses	neg
efficiency is best achieved through a market economy	pos
the only way to determine what society actually wants is by allowing private enterprise to use their resources in competing to meet the needs of consumers	pos
Without a market in which allocations can be made in obedience to the law of supply and demand, it is difficult or impossible to funnel resources with respect to actual human preferences and goals	pos
Less corruption and less political violence have been found to be correlated with free markets	pos
political and civil liberties have simultaneously expanded with market-based economies	pos
Political freedom is the corollary of economic freedom	pos
Higher economic freedom correlates strongly with higher self-reported happiness	pos
the responsibility of government should involve enough surveillance over the enterprise system to ensure the social usefulness of all economic activity	pos
It should be the policy of government to aid and foster certain activities or kinds of business that strengthen a nation	pos
Self-interested competition in the free market would tend to benefit society as a whole	pos
a true laissez-faire economy would quickly become a conspiracy of businesses and industry against consumers	neg
Markets would lead to equality	pos
the market is the most fair and efficient arbitrator of resources	pos
only market capitalism could manage a complex, modern economy	pos
the information problems facing any other form of economic organization other than market capitalism would exceed its capacity to handle information	neg
market economies are inherently stable if left to themselves	pos
depressions result only from government intervention	neg
the market is able to coordinate itself	pos
competition leads to innovation and more affordable prices	pos
Governmental intervention can result in potential gains in efficiency	pos
the market on its own does not allocate resources efficiently	neg
imperfect markets are often better than imperfect governmental alternatives	pos
centralized operations of economic activity is always accompanied by political repression	neg
the government has a role to play in the economy	pos
Liberty is possible only with social justice and an equitable distribution of wealth and power, which in turn require a degree of active government intervention	pos
Central economic planning leads towards totalitarianism	neg
a central planning authority would have to be endowed with powers that would impact and ultimately control social life	neg
while in centrally planned economies an individual or a select group of individuals must determine the distribution of resources, these planners will never have enough information to carry out this allocation reliably	neg
the efficient exchange and use of resources can be maintained only through the price mechanism in free markets	pos
"the state has a role to play in the economy, and specifically, in creating a ""safety net"	pos
In a free market, both labor and capital would receive the greatest possible reward	pos
"an unfettered market"" is the most efficient mechanism to satisfy human needs and channel resources to their most productive uses"	pos
Any government intervention is seen as useless	neg
free markets have the potential to free states from the looming prospect of recurrent warfare	pos
Laissez-faire economics is expected to diminish the frequency of war	pos
many of the services performed by government could be performed better by the private sector	pos
economic freedom is not only desirable in itself but is also a necessary condition for political freedom	pos
Freer markets result in freer people	pos
markets could go wrong	neg
government intervention could serve a useful purpose	pos
competition in the free market is more effective than the regulation of industry	pos
all government intervention in the economy is wasteful	neg
"free market economics"" is the most efficient way to promote economic growth"	pos
free markets work best	pos
free markets are the only ethical markets	pos
it is not prudent for governments to intervene in markets	neg
principles of individual liberty morally dictate support for free markets	pos
Free markets are the most productive markets	pos
a bigger role of the government in the economy will make people feel less responsible for the society	neg
"free markets are ""simply more productive"	pos
the allocation of goods and services by a free market is not efficient	neg
Market failures are viewed as a very common problem of any unregulated market system	neg
the costs of government failure might be worse than those of the market failure it attempts to fix	neg
markets have inefficient outcomes	neg
markets have inefficient and democratically-unwanted outcomes	neg
Free-market capitalism is seen as the basis for a free and prosperous society	pos
States use their coercive powers to benefit some businesses and individuals at the expense of others	neg
no coercive monopoly of force can arise on a truly free market	pos
in an environment of laissez-faire, a spontaneous order of cooperation in exchanging goods and services emerges that satisfies human wants	pos
monopoly can only come about through government intervention	neg
authority over the economy leads to totalitarianism	neg
free markets provide the greatest possible equity and prosperity	pos
any interference with the market process decreases social well being	neg
unfettered markets maximize individual freedom	pos
Unfettered markets are the best means to economic growth	pos
the best interests in a given society are achieved by allowing its participants to pursue their own financial self-interest with little or no restraint	pos
Unfettered markets do not lead to social justice	neg
the common interest is best served by allowing participants to pursue their self-interest	pos
Free market can be inefficient	neg
laissez-faire government policy is more desirable than government intervention in the economy	pos
regulation ensures that a safe and appropriate service is delivered, while not discouraging the effective functioning and development of businesses	pos
customers desire protection from market power when competition is non-existent or ineffective	pos
market regulation is important for safeguarding against monopoly formation	pos
The regulation of markets is widely acknowledged as important to safeguard social and environmental values	pos
markets depend on state regulation for their stability	pos
government intervention creates more problems than it is supposed to solve	neg
monopolies have historically developed only because of government intervention rather than due to a lack of intervention	neg
central planners would not know how to allocate the available resources efficiently	neg
a free market is efficient at resource allocation	pos
modern developments in information technology open up the possibility of a planning system that could outperform the market in terms of efficiency	pos
the cooperation of a free market is superior “because it is the only method by which our activities can be adjusted to each other without coercive or arbitrary intervention of authority	pos
"The only chance to build a decent world is ""to improve the general level of wealth"" via the activities of free markets"	pos
government intervention in markets would lead to a loss of freedom	neg
"negative externalities"") cannot effectively be regulated solely by the marketplace"	neg
free' competition means for the great mass of people a tyranny probably worse, because more irresponsible, than that of the state	neg
Unfettered markets undermine the social order	neg
private sector decisions sometimes lead to inefficient macroeconomic outcomes which require active policy responses by the public sector	neg
Active government policy can be effective in managing the economy	pos
Centralized planning leads to malinvestment of capital	neg
what starts as temporary governmental fixes usually become permanent and expanding government programs, which stifle the private sector and civil society	neg
Laissez-faire capitalist economics can operate well on their own, without state intervention	pos
massive waves of unemployment, as in economic recessions and depressions, can be traced back to state intervention in the market	neg
government intervention is the cause of economic crises	neg
left to its devices, the market will adjust efficiently	pos
a free market environment) would not be able to adjust effectively to excess supply and demand	neg
free markets can solve the economy's problems automatically	pos
Advertising is a powerful educational tool capable of reaching and motivating large audiences	pos
advertising can be seen as necessary for economic growth	pos
Advertising is not without social costs	neg
Advertising is increasingly invading public spaces	neg
advertising frequently uses psychological pressure	neg
advertisements exploit the desires of a consumer	neg
many forms of outdoor advertising blight the public realm	neg
Advertising increasingly invades public spaces	neg
Advertising occupies public space and more and more invades the private sphere of people	neg
Advertising is considered the most prevalent and toxic of the mental pollutants	neg
20th century advertising is the most powerful and sustained system of propaganda in human history	neg
Advertising's cumulative cultural effects, unless quickly checked, will be responsible for destroying the world as we know it	neg
the deepest recesses of the human psyche – become mere means for the expansion of the commodity universe under the force of modern marketing	neg
the commercial basis of media, journalism, and communication could have troubling implications for democracy	neg
Advertising itself is extensively considered to be a contribution to culture	pos
The steady normalization of invasive advertising dulls the public’s perception of their surroundings	neg
With increasing force advertising makes itself comfortable in the private sphere so that the voice of commerce becomes the dominant way of expression in society	neg
Advertising increasingly reduces young people to consumers	neg
Advertising often uses stereotype gender specific roles of men and women reinforcing existing clichés	neg
Advertising has been criticized as inadvertently or even intentionally promoting sexism	neg
advertising often reinforces stereotypes	neg
"Women and men in advertising are frequently portrayed in unrealistic and distorted images that set a standard for what is considered ""beautiful"	neg
advertisements promote a negative message about body image	neg
massive advertising has a detrimental effect on children	neg
advertising directed at young children is per se manipulative	neg
"The ""hyper-commercialization of the culture is recognized and roundly detested by the citizenry"	neg
Advertising incessantly demonstrates the prostitution men and women	neg
Advertising helps to shatter and ultimately destroy our most precious non-material possessions	neg
The images in advertising depict stereotypical gender roles	neg
Advertisements take something that exists already in the world and they change it, forming a distorted reflection	neg
"advertising has unjustly ""colonized"" public, discursive and psychic spaces"	neg
advertising focuses on looking toward external rewards for a sense of self	neg
online advertising has implications on the privacy and anonymity of users	neg
advertising has the potential to persuade people into commercial transactions that they might otherwise avoid	neg
Advertisers find ways to deceive consumers	neg
advertising is misleading	neg
the advertising techniques used to create consumer behaviour amount to the destruction of psychic and collective individuation	neg
ads create a hyper-real world where commodities appear as the key to securing happiness	neg
advertising attempts to equate the social with the material by utilizing images and slogans to link commodities with the real sources of human happiness	neg
Ads are a detriment to society because they tell consumers that accumulating more and more possessions will bring them closer to self-actualization	neg
advertisement images disempower and objectify the consumer	neg
Advertising constructs a simulated world that offers fantastical escapism to consumers, rather than reflecting actual reality	neg
ads depict the interests and lifestyles of the elite as natural; cultivating a deep sense of inadequacy among viewers	neg
teen advertising negatively impacts teenagers’ self-esteem	neg
"advertising can ""impose a sense of inadequacy on young women's self-concepts"	neg
Exposure to ultra-thin models in advertisements and magazine pictures produces depression	neg
Low self-esteem that stems from teenage advertising can have detrimental effects on teenagers	neg
any kind of marketing is inherently evil	neg
marketing promotes consumerism and waste	neg
Advertising creates artificiality	neg
Children are not capable of resisting or understanding marketing tactics	neg
The advertising of certain products may strongly offend some people	neg
deceptive marketing can be presented to consumers	neg
Choosing to be childfree is both difficult and undesirable	neg
It is immoral to create children	neg
one can make a greater contribution to humanity through one's work than through having children	neg
it is wrong to intentionally have a child when there are so many children available for adoption	neg
it is inherently immoral to bring people into the world	neg
one may generally wish to spare a potential child from the suffering of life	pos
Being childless is considered bizarre	neg
raising children is a very important activity	pos
Having children is such a positive contribution to the world	pos
overpopulation is a serious problem	neg
by avoiding reproduction for ethical reasons the childfree will only aid deterioration of concern for the environment and future generations	neg
childfree people face not only social discrimination but political discrimination as well	neg
there ought to be a higher rate of population growth than what is currently mainstream	pos
That trouble and pain which the parents undergo on the birth of their children cannot be compensated even in a hundred years	neg
antinatalist policies could solve problems such as overpopulation	pos
the birth of a new person always entails nontrivial harm to that person	neg
there is a moral imperative not to procreate	pos
Human extinction would prevent environmental degradation	pos
a decrease in the human population would prevent a significant amount of man-made human suffering	pos
Human extinction is the best solution to the problems facing the Earth's biosphere and humanity	pos
Most of the dangers faced by the planet are attributed to human overpopulation	neg
the extinction of humanity would be the best solution to the Earth's environmental problems	pos
the human population is far greater than the Earth can handle	neg
the best thing for Earth's biosphere is for humans to voluntarily cease reproducing	pos
human existence is causing environmental damage which will eventually bring about the extinction of humans (as well as other organisms	neg
human existence has ultimately been destructive to the Earth and many of its non-human organisms	neg
Voluntary human extinction will prevent human suffering and the extinction of other species	pos
many species are threatened by the increasing human population	neg
Abstinence from reproduction is seen as an altruistic choice	pos
non-reproduction would eventually allow humans to lead idyllic lifestyles	pos
procreation today is de facto child abuse	neg
the standard of human life will worsen if resources are consumed by a growing population	neg
attempting to reduce the Earth's population is the only moral option	pos
having children is frequently viewed as a measure of success	pos
voluntary human extinction is advisable due to limited resources	pos
The effects of a declining population can be adverse for an economy	neg
the average standard of living in a declining population, at least in terms of material possessions, will tend to rise	pos
economic growth requires population growth	pos
economic growth is impossible during a population decline	neg
it has been claimed to be morally objectionable to bring a potential person into existence	neg
avoidance from conceiving a child when there are prerequisites for raising it is comparable to causing the death of one	neg
the decision not to procreate at all could be regarded as immoral	neg
when good people stop having kids, society fails	neg
the best thing for a man is not to be born	pos
A large dam can cause the loss of entire ecospheres	neg
dam construction requires the state to displace individual people	neg
Dam construction often leads to abuses of the masses by planners	neg
people worldwide have been physically displaced from their homes as a result of dam construction	neg
The number of sites that can be economically developed for hydroelectric production is limited	neg
Hydroelectric generation can be vulnerable to major changes in the climate	neg
a hydroelectric power source is usually comparatively cheap and reliable	pos
A hydroelectric power source has no fuel and low escape risk	pos
As an alternative energy source a hydroelectric power source is cheaper than both nuclear and wind power	pos
Dam failures are generally catastrophic	neg
adverse environmental and sociological impacts have been identified during and after many reservoir constructions	neg
The reservoir waters spill out into the surrounding environments, flooding the natural habitats that existed before the dam’s construction	neg
Reservoirs can also contribute to greenhouse gas emissions	neg
The construction of a dam blocks the flow of sediment downstream, leading to downstream erosion	neg
reservoirs can become breeding grounds for disease vectors	neg
Dams and the creation of reservoirs also require relocation of potentially large human populations	neg
Dams attenuate floods which may affect the ecology and agriculture seriously	neg
Reservoirs may contribute to changes in the Earth's climate	neg
Traditional hydro dams store enormous quantities of water in reservoirs, necessitating the flooding of large tracts of land	neg
hydro harnesses the natural energy of water and gravity, eliminating the need to burn coal or natural gas	pos
The benefits of the dams are not only limited to hydropower	pos
Many dams are multi-purpose dams	pos
The construction of large dams entails many tangible and intangible costs	neg
Resettlement adds to the social costs of the dams	neg
Environmental costs are imposed on communities living downstream of the dams	neg
reliance on hydropower makes electricity generation vulnerable to droughts	neg
dams are not likely to generate a large financial rate of return	neg
People would have to be resettled to make room for dams and reservoirs	neg
Hydropower generation is vulnerable to droughts	neg
In many reservoir construction projects people have to be moved and re-housed	neg
Reservoir failures can generate huge increases in flow down a river valley with the potential to wash away towns and villages and cause considerable loss of life	neg
Hydroelectric reservoirs release a large pulse of carbon dioxide	neg
greenhouse gas emissions from the reservoir could be higher than those of a conventional oil-fired thermal generation plant	neg
electricity produced from hydroelectric generation does not give rise to any flue gas emissions from fossil fuel combustion	pos
Dams can also flood various ecosystems on land and may cause extinctions	neg
Dams can severely reduce the amount of water reaching countries downstream of them, causing water stress between the countries	neg
Farms and villages can be flooded by the creation of reservoirs, ruining many livelihoods	neg
Dam failures can cause immense damage and loss of life	neg
Hydroelectricity is the most widely used form of renewable energy	pos
The cost of hydroelectricity is relatively low	pos
Hydro is a flexible source of electricity	pos
Damming can harm local ecosystems	neg
building large dams and reservoirs often involves displacing people and wildlife	neg
Once a hydroelectric complex is constructed, the project produces no direct waste	pos
The major advantage of hydroelectricity is elimination of the cost of fuel	pos
The cost of operating a hydroelectric plant is nearly immune to increases in the cost of fossil fuels	pos
Hydroelectric plants have long economic lives	pos
hydroelectric dams do not burn fossil fuels	pos
hydroelectricity produces the least amount of greenhouse gases and externality of any energy source	pos
Large hydro dams can control floods, which would otherwise affect people living downstream of the project	pos
Large reservoirs required for the operation of hydroelectric power stations result in submersion of extensive areas upstream of the dams, destroying biologically rich and productive lowland	neg
reservoirs cause habitat fragmentation of surrounding areas	neg
Hydroelectric projects can be disruptive to surrounding aquatic ecosystems	neg
lower water ﬂow and alterations in the rainfall regime, could reduce total energy production	neg
greenhouse gas emissions from the reservoir may be higher than those of a conventional oil-fired thermal generation plant	neg
Another disadvantage of hydroelectric dams is the need to relocate the people living where the reservoirs are planned	neg
people worldwide had been physically displaced as a direct result of dam construction	neg
Dam failures have been some of the largest man-made disasters in history	neg
Dams are tempting industrial targets for wartime attack	neg
Hydroelectricity eliminates the flue gas emissions from fossil fuel combustion	pos
Hydroelectricity is a renewable energey source	pos
Hydroelectric plants can be easily regulated to follow variations in power demand	pos
Investing in renewable energy can have significant dividends for our energy security	pos
renewable energy is naturally replenished and not subject to the volatility of global fuel markets	pos
Renewable power technologies have significant environmental benefits	pos
The major advantage of hydroelectric systems is the elimination of the cost of fuel	pos
hydroelectric power can be far less expensive than electricity generated from fossil fuels or nuclear energy	pos
areas with abundant hydroelectric power attract industry	pos
Disadvantages of hydroelectricity systems include: dislocation of people living where the reservoirs are planned	neg
Hydroelectric power is now more difficult to site in developed nations	neg
"Hydro-energy and large dams may not be considered ""clean"" nor ""renewable"" sources of electricity"	neg
renewable electricity technologies present policy makers with a superior alternative for minimising the risk of fuel interruptions and shortages	pos
As time progresses, renewable energy generally gets cheaper,[REF][REF] while fossil fuels generally get more expensive	pos
once the renewable infrastructure is built, the fuel is free forever	pos
Hydroelectric plants have the advantage of being long-lived	pos
Hydropower is an extremely flexible technology	pos
Large hydropower provides one of the lowest cost options in today’s energy market	pos
there are several significant social and environmental disadvantages of large-scale hydroelectric power systems	neg
hydro dams and transmission lines have significant effects on water and biodiversity	neg
Development of large-scale hydroelectric power has environmental impacts	neg
The filling of large reservoirs can induce earth tremors, which may be large enough to be objectionable or destructive	neg
A large dam can endanger ecosystems by restricting the motion of marine animals	neg
even a slow flowing stream of water, or moderate sea swell, can yield considerable amounts of energy	pos
The environmental benefits of renewable energy technologies are widely recognised	pos
threats to our old energy systems provide a rationale for investing in renewable energy	pos
pumped-storage hydroelectricity (PSH) is the largest-capacity form of grid energy storage available	pos
Pumped water storage systems are used to smooth out demand variations	pos
Hydroelectric dams with large reserviors can be operated to provide peak generation at times of peak demand	pos
hydro plants are highly dispatchable	pos
Hydro plants are able to act as load following power plants	pos
A hydroelectric plant's production may be affected by requirements to keep the water level from getting to high or low	neg
Hydroelectric plants have high availability factors	pos
Renewable energy technologies are essential contributors to sustainable energy	pos
Renewable energy technologies generally contribute to world energy security, reducing dependence on fossil fuel resources	pos
Among sources of renewable energy, hydroelectric plants have the advantages of being long-lived	pos
hydroelectric plants are clean and have few emissions	pos
hydroelectric plants produce much lower life-cycle emissions than other types of generation	pos
Integrating ever-higher levels of renewables is being successfully demonstrated in the real world	pos
Hydroelectric power is usually extremely dispatchable and more reliable than other renewable energy sources	pos
hydro plants can help allow for intermittency of other plants	pos
Hydro is  a low-cost source of electricity	pos
potential hydroelectric sites are becoming scarce	neg
Hydropower can be intermittent	neg
Many plants do not have enough water to operate anywhere near their full capacity on a continuous basis	neg
Hydropower is an extremely flexible technology from the perspective of power grid operation	pos
There are no harmful emissions associated with hydroelectric plant operation	pos
The construction of new hydroelectric power plants means environmental impacts as large areas need to be flooded, altering the ecosystem	neg
New dams mean very elevated social and environmental costs	neg
Large hydroelectric power plants flooding immense forest areas emit large amounts of methane to the atmosphere	neg
Truth and reconciliation commissions can provide proof against historical revisionism of state terrorism and other crimes and human rights abuses	pos
Truth commissions are sometimes criticised for allowing crimes to go unpunished, and creating impunity for serious human rights abusers	neg
abuses of human rights have gone unpunished under truth commissions	neg
The TRC  is weighted in favour of the perpetrators of abuse	neg
Truth-seeking processes allow societies to examine and come to grips with past crimes and atrocities and prevent their future repetition	pos
Through a truth-seeking process, actors in a country are able to investigate past abuses. and seek redress for victims and their families	pos
victims and communities affected by past crimes have the right to know the identity of suspected perpetrators	pos
Truth-seeking processes aim to enable societies to examine and come to terms with past crimes and human rights violations in order to prevent their recurrence	pos
Truth seeking processes can also help victims obtain closure	pos
Truth commissions risk conflicting or undermining criminal prosecutions	neg
if all perpetrators of human rights abuses do not stand trial, impunity for crimes will continue	neg
the only way to effectively end violence is by granting amnesties	pos
Transitional justice is linked to security and development	pos
Transitional justice is one of the signaling mechanisms that governments can use to show that they are breaking away from past practices	pos
transitional justice measures can send signals about the importance of accountability	pos
human rights violations and crimes against humanity must be prosecuted	neg
Restorative justice provides help for the offender in order to avoid future offences	pos
Restorative justice that fosters dialogue between victim and offender shows the highest rates of victim satisfaction	pos
Restorative approaches seek a balanced approach to the needs of the victim, wrongdoer and community through processes that preserve the safety and dignity of all	pos
Democratization empowers people legally in entitling them to practice freedom	pos
it is very difficult (or even impossible) for democracy to be implemented immediately in a country that has no prior experience with it	neg
democracies don't go to war with each other	pos
democracies tend to be wealthier than other countries	pos
democracy might cause peace	pos
countries in transition to democracy are especially likely to be involved in wars	neg
all democracies, whether young or established, go into war with one another less frequently	pos
democracies do not fight one another	pos
democracies are more peaceful in general	pos
wars between democracies are less likely	pos
democracies have less internal systematic violence	pos
genocide and politicide are rare in democracies	pos
the more democratic a regime, the less its democide	pos
democracy causes peace	pos
democracy is ineffective in preventing war	neg
spreading democracy is likely to spread peace	pos
democracies treat each other with trust and respect even during crises	pos
the continuing increase in democracy worldwide will soon lead to an end to wars and democide	pos
the best strategy to ensure our security and to build a durable peace is to support the advance of democracy elsewhere	pos
The best protection for our security is a world of well-governed democratic states	pos
Attempts to create democracies by using external force often fail	neg
larger democracies are unable to allow a sufficient number of their citizens to have their voices heard	neg
the parliamentary system subordinates the national interest, or common good, to private interests	neg
The official goal of democracy of eliminating elite rule is impossible	neg
democracy is a façade legitimizing the rule of a particular elite	neg
countries with a democratic system of governance are less likely to go to war	pos
democracy gives poor people an opportunity to improve their lot	pos
Democracy is economically inefficient	neg
democracy is efficient	pos
democracies are inefficient	neg
the will of the democratic majority may not always be in the best interest of all citizens within the country or beneficial to the future of the country itself	neg
voters may not be educated enough to exercise their democratic right	neg
Good education is present in allmost all emeging democracies	pos
the benefits of a specialised society may be compromised by democracy	neg
a democratic government may not be providing the most good for the most amount of people	neg
democracies will tend to cater to the whims of the people	neg
Democracies decay into anarchy	neg
democracy is criticised for not offering enough political stability	neg
democracy is undesirable for a developing country	neg
A majority bullying a minority is just as bad as a dictator, communist or otherwise, doing so	neg
democracy will result in the people's distrust and disrespect of governments	neg
The new establishment of democratic institutions in countries where the associated practices have as yet been uncommon or deemed culturally unacceptable, can result in institutions, that are not sustainable in the long term	neg
corruption still is rife in spite of democratically elected governments	neg
a positive relationship exists between democratic governance and peace	pos
Democracy is viewed as a means of promoting moderation and stability and preventing terrorism	pos
democracy would bring peace	pos
democracy leads to chaos	neg
the inclusive nature of democracy can lift the fear of difference that some believe is a license to kill	pos
democracy can help to build trust and settle old disputes with dignity	pos
democracy can be a path to lasting justice	pos
democratic nations have much less democide or murder by government	pos
democracies would be inherently unstable and chaotic in their policies due to the changing whims of the people	neg
Democracy is contrary to human nature	neg
majority rule is preferable to other systems	pos
democracy leads to less internal violence and mass murder by the government	pos
democracy aims at reducing political uncertainty and instability	pos
democracy could be easily exploited by leaders with dictatorial aspirations	neg
A democratic system may provide better information for policy decisions	pos
The democratic system provides a way to replace inefficient leaders and policies	pos
more democracy increases economic freedom	pos
Democracies have the potential to put in place better education	pos
Democratic nations have less genocide and politicide	pos
only in a democracy the citizens can have a share in freedom	pos
the concept of democracy as a constant process is flawed and detrimental	neg
democratic institutions would do no more than shift the exercise of power from oppression to manipulation	neg
democracy has repeatedly proven to be a fundamentally better system (ethically, politically, economically) than any of the alternatives	pos
democracy is actually a decline of civilization	neg
people must have the opportunity to decide what political matters actually are and what should be brought up for deliberation	pos
Democracy is reckless and arbitrary	neg
democracies have ever been found incompatible with personal security or the rights of property	neg
democracy cannot subsist long nor be carried far into the departments of state	neg
Democracy in general is criticized for ignoring the rights of the minority	neg
democracy and freedom are indispensable ingredient for a stable political system	pos
